<b> パスからデータフレームを <a> 区切りで読み込んで、 <C> にする	<C> = pd . read_csv ( <b> , sep = <a> )	 pd . read_csv ( <b> , sep = <a> ) 
データフレーム <A> の列の名前を <b> から <c> に、 <d> から <e> にリネームする	<A> . rename ( columns = { <b> : <c> , <d> : <e> } )	 <A> . rename ( columns = { <b> : <c> , <d> : <e> } ) 
<A> の <b> ごとに <c> の個数をカウントする	<A> . groupby ( [ <b> ] ) [ <c> ] . count ( )	 <A> . groupby ( [ <b> ] ) [ <c> ] . count ( ) 
レンジを <b> から <a> として、 <C> のヒストグラムを描画する	plt . hist ( <C> , range = ( <b> , <a> ) )	 sns . hist ( <C> , range = ( <b> , <a> ) ) 
表 <B> の <a> をグループ化して、値ごとのデータの数	<B> . groupby ( <a> ) . size ( )	 <C> . groupby ( <a> ) [ <b> ] . size ( ) 
表 <A> のデータの性質を確認する	<A> . info ( )	 <A> . info ( ) 
データフレーム <B> の <a> コラムについての標準偏差を表示する	<B> [ <a> ] . std ( )	 <D> [ <a> ] . std ( ) 
データフレーム <A> の <b> と表属性 <c> ごとに <d> の値の合計を計算する	<A> . groupby ( [ <b> , <c> ] ) [ <d> ] . sum ( )	 sns . groupby ( [ <A> [ <b> , <c> ] ) [ <d> ] . sum ( ) 
データフレームを <a> からカンマ区切りで読み込む	pd . read_csv ( <a> , sep = ',' )	 pd . read_csv ( <a> , sep = ',' ) 
データフレーム <A> の列の名前を <b> から <c> に変更する	<A> . rename ( columns = { <b> : <c> } )	 <A> . rename ( columns = { <b> : <c> } ) 
<a> ファイルから表データをタブ区切りで読み、 <B> とする	<B> = pd . read_csv ( <a> , sep = '\\\\t' )	 pd . read_csv ( <a> , sep = '\\\\t' ) 
表 <B> のコラム <a> をソートする	<B> . sort_values ( <a> )	 pd . merge ( <B> , <A> ) 
ビンの名前をリスト <D> として、 <A> の <b> コラムを分割数を整数値 <C> として分割する	pd . cut ( <A> [ <b> ] , <C> , label = <D> )	 pd . cut ( <A> [ <b> ] , <C> , label = <D> ) 
表データ <B> の <a> 中の前後の行の差分を計算	<B> [ <a> ] . diff ( periods = 1 )	 <B> [ <a> ] . diff ( periods = 1 ) 
<A> の <b> カラムと <c> カラムと <d> についての箱ひげ図を描画する	plt . boxplot ( [ <A> [ <b> ] , <A> [ <c> ] , <A> [ <d> ] ] )	 plt . boxplot ( [ <A> [ <b> ] , <A> [ <c> ] , <A> [ <d> ] ] ) 
色を <C> として、 <A> と <B> のグラフを描写する	plt . plot ( <A> , <B> , color = ( <C> ) )	 pd . merge ( <A> , <B> , color = ( <C> ) ) 
<B> の <a> を中央値で分割する	pd . qcut ( <B> [ <a> ] , 2 )	 <B> [ <a> ] . pd . qcut ( ) 
データフレーム <C> の <b> をビン数を <A> として分割する	pd . cut ( <C> [ <b> ] , <A> )	 <C> . pd ( [ <b> ] , <A> ) 
<B> の <a> コラムを四分位数ごとでビン分割する	pd . qcut ( <B> [ <a> ] , 4 )	 4 pd . qcut ( <B> [ <a> ] , 4 ) 
データフレーム <A> の欠損がある行をドロップする	<A> . dropna ( )	 <A> . dropna ( ) 
カンマ区切りでデータフレームを <a> から読み込み、 <B> とする	<B> = pd . read_csv ( <a> , sep = ',' )	 <B> = pd . read_csv ( <a> , sep = ',' ) 
グラフのタイトルを <a> に変更する	plt . title ( <a> )	 title . title ( <a> ) 
ビンの名前を 0 始まりの連番として、 <C> 表の <b> を分割数を <A> として分割する	pd . cut ( <C> [ <b> ] , <A> , label = False )	 pd . cut ( <C> [ <b> ] , <A> , label = False ) 
表を <b> ファイル名からカンマ区切りで読み込み、 <A> にする	<A> = pd . read_csv ( <b> , sep = ',' )	 <E> = pd . read_csv ( <b> , sep = ',' ) 
表データ <C> のカラム <b> と <a> を確認する	<C> [ [ <b> , <a> ] ]	 pd . merge ( <C> [ <b> , <a> ] , axis = 1 ) 
ビンの名前をインデックスとして、表 <C> の <b> 表属性を分割数を <A> としてビン分割する	pd . cut ( <C> [ <b> ] , <A> , label = False )	 pd . cut ( <C> [ <b> ] , <A> , label = False ) 
表 <B> の <a> についての要約統計量を見る	<B> [ <a> ] . describe ( )	 include <B> [ <a> ] . describe ( ) 
表 <C> の <b> 表属性を分割数を整数値 <A> として要素数が等しくなるようにビン分割する	pd . qcut ( <C> [ <b> ] , <A> )	 import . pd ( <C> [ <b> ] , <A> ) 
凡例をグラフ内の最適な位置に付ける	plt . legend ( loc = 'best' )	 <A> . plt ( loc = 'best' ) 
表データ <A> の <b> 表属性が <c> か <d> のデータを抽出する	<A> [ <A> [ <b> ] . isin ( [ <c> , <d> ] ) ]	 from <A> [ <A> [ <b> ] . isin ( [ <c> , <d> ] ) ] 
表 <B> の <a> についてのヒストグラムを描く	plt . hist ( <B> [ <a> ] )	 <B> [ <a> ] . hist ( ) 
表 <B> の <a> の出現回数	<B> [ <a> ] . value_counts ( )	 <B> [ <a> ] . value_counts ( ) 
<C> の <b> カラムを境界値を <A> リストとして分割する	pd . cut ( <C> [ <b> ] , <A> )	 pd . cut ( <C> [ <b> ] , <A> ) 
表 <C> の列 <b> と列 <a> を消す	<C> . drop ( [ <b> , <a> ] , axis = 1 )	 <C> . drop ( [ <b> , <a> ] , axis = 1 ) 
表データ <B> にある <a> を欠損値とする	<B> . replace ( <a> , np . nan )	 import . replace ( <a> , np . nan ) 
表データ <A> の <b> コラムが <c> より大きいデータを抽出する	<A> [ <A> [ <b> ] >  <c> ]	 plt . boxplot ( <A> [ <b> ] , <A> [ <c> ] ) ] 
データフレーム <A> のコラム <b> についての箱ひげ図を描写する	plt . boxplot ( <A> [ <b> ] )	 <A> [ plt . boxplot ( <b> ] ) 
表 <C> の <b> 表属性をビン数を <A> 整数値として分割する	pd . cut ( <C> [ <b> ] , <A> )	 import . pd ( <C> [ <b> ] , <A> ) 
表データ <D> の <c> と <b> とカラム <a> について関係性を一気に描く	sns . pairplot ( <D> [ [ <c> , <b> , <a> ] ] )	 <D> [ [ <c> , <b> , <a> ] ] . pairplot ( ) 
表データ <A> の <b> 列と <c> 列の相関係数	<A> [ [ <b> , <c> ] ] . corr ( )	 sns . pairplot ( <A> [ [ <b> , <c> ] ] ) 
<A> のコラム <b> が <c> より大きいデータを抽出する	<A> [ <A> [ <b> ] >  <c> ]	 plt . boxplot ( <A> [ <b> ] , <A> [ <c> ] ) ] 
<c> 区切りで表データを <b> から読んで、 <A> とする	<A> = pd . read_csv ( <b> , sep = <c> )	 pd . read_csv ( <b> , sep = <c> ) 
表データ <A> の <b> を NaN に置換し、 NaN が存在する行を消す	<A> . replace ( <b> , np . nan ) . dropna ( )	 <A> . replace ( <b> , np . nan ) . dropna ( ) 
<A> の <b> をソートする	<A> . sort_values ( <b> )	 <A> . sort_values ( <b> ) 
表 <C> の <b> を境界値を <A> として分割する	pd . cut ( <C> [ <b> ] , <A> )	 pd . cut ( <C> [ <b> ] , <A> ) 
表 <A> の <b> 列と <c> と <d> 列について関係性を一度にプロットする	sns . pairplot ( <A> [ [ <b> , <c> , <d> ] ] )	 . pairplot ( <A> [ [ <b> , <c> , <d> ] ] ) 
<B> 内の <a> を欠損に置換し、欠損がある行をドロップする	<B> . replace ( <a> , np . nan ) . dropna ( )	 <E> . dropna ( <B> , np . nan ) . dropna ( ) 
表データ <A> の欠損値を <A> 表データの平均値で補う	<A> . fillna ( <A> . mean ( ) )	 <A> . fillna ( <A> . mean ( ) ) 
データフレーム <C> の <b> ごとにコラム <a> の平均を求める	<C> . groupby ( [ <b> ] ) [ <a> ] . mean ( )	 <A> . groupby ( [ <b> ] ) [ <a> ] . mean ( ) 
<A> の <b> についての平均値	<A> [ <b> ] . mean ( )	 <A> [ <b> ] . mean ( ) 
データフレーム <B> のコラム <a> のユニークな要素数	<B> [ <a> ] . nunique ( )	 <B> [ <a> ] . nunique ( ) 
データフレーム <A> の <b> と <c> コラムの相関係数	<A> [ [ <b> , <c> ] ] . corr ( )	 [ <A> [ <b> , <c> ] ] . corr ( ) 
表 <A> の形状	<A> . shape	 from ) 
データフレーム <A> の <b> 列ごとに列 <c> の個数を数える	<A> . groupby ( [ <b> ] ) [ <c> ] . count ( )	 <A> . groupby ( [ <b> ] ) [ <c> ] . count ( ) 
ビンの名前を整数値として、データフレーム <A> の <b> をビン数を <C> として分割する	pd . cut ( <A> [ <b> ] , <C> , label = False )	 pd . cut ( <A> [ <b> ] , <C> , label = False ) 
インデックスと <a> をキーとしてデータフレーム <C> と <B> データフレームをマージする	pd . merge ( <C> , <B> , left_index = True , right_on = <a> )	 pd . merge ( <C> , <B> , left_index = True , right_on = <a> ) 
<A> の <b> 列と <c> ごとに <d> の値の合計を算出する	<A> . groupby ( [ <b> , <c> ] ) [ <d> ] . sum ( )	 sns . groupby ( [ <A> [ <b> , <c> ] ) [ <d> ] . sum ( ) 
データフレーム <A> の <b> 列のバリュー	<A> [ <b> ] . values	 <A> [ <b> ] . values 
表 <B> の下 <a> 行を表示する	<B> . tail ( <a> )	 <C> . tail ( <a> ) 
データフレーム <B> の欠損値を <A> に置き換える	<B> . fillna ( <A> )	 <A> . fillna ( <B> ) 
データフレーム <D> の <c> と <b> ごとに <a> の値の合計を計算する	<D> . groupby ( [ <c> , <b> ] ) [ <a> ] . sum ( )	 <D> . groupby ( [ <c> , <b> ] ) [ <a> ] . sum ( ) 
データフレーム <A> の <b> を境界値を <C> リストとして分割する	pd . cut ( <A> [ <b> ] , <C> )	 pd . cut ( <A> [ <b> ] , <C> ) 
インデックスと <c> をキーとしてデータフレーム <A> と <B> を一つにまとめる	pd . merge ( <A> , <B> , left_index = True , right_on = <c> )	 . pd ( <A> , <B> , left_index = True , right_on = <c> ) 
<A> の <b> 列と <c> と <d> について関係性を一気に描写する	sns . pairplot ( <A> [ [ <b> , <c> , <d> ] ] )	 sns . pairplot ( <A> [ [ <b> , <c> , <d> ] ] ) 
<B> にある <a> を欠損値に置換する	<B> . replace ( <a> , np . nan )	 np . replace ( <B> , np . nan ) 
グラフを描画する	plt . show ( )	 plt . show ( ) 
<A> の欠損を <A> 表の平均値で補う	<A> . fillna ( <A> . mean ( ) )	 <A> . fillna ( <A> . mean ( ) ) 
ビンの名前を 0 始まりの連番として、 <C> のカラム <b> をビン数を整数値 <A> として分割する	pd . cut ( <C> [ <b> ] , <A> , label = False )	 pd . cut ( <C> [ <b> ] , <A> , label = False ) 
表 <A> の <b> を削除する	<A> . drop ( [ <b> ] )	 pd . drop ( <A> [ <b> ] ) 
表データ <A> の末尾 <b> 行	<A> . tail ( <b> )	 <A> . tail ( <b> ) 
データフレーム <A> の <b> 表属性を中央値で分割する	pd . qcut ( <A> [ <b> ] , 2 )	 <A> . pd ( [ <b> ] , 2 ) 
データフレーム <B> の <a> を日付に変換する	pd . to_datetime ( <B> [ <a> ] , format = '%Y-%m-%d' )	 <B> pd . to_datetime ( <a> , format = '%Y-%m-%d' ) 
表データ <A> 内の欠損値を直前の行の値で補う	<A> . fillna ( method = 'ffill' )	 method . fillna ( <A> . method = 'ffill' ) 
<a> という軸ラベルを y 軸に付ける	plt . ylabel ( <a> )	 plt . ylabel ( <a> ) 
Matplotlib ライブラリをインポートする	from matplotlib import pyplot as plt	 matplotlib import pyplot as sns 
表データ <A> の欠損を <A> の平均値で埋める	<A> . fillna ( <A> . mean ( ) )	 <A> . fillna ( <A> . mean ( ) ) 
<B> の <a> の前後の行の差分を算出	<B> [ <a> ] . diff ( periods = 1 )	 periods <B> [ <a> ] . diff ( periods = 1 ) 
ビンのラベルを <D> として、 <A> の <b> をビン数を <C> として分割する	pd . cut ( <A> [ <b> ] , <C> , label = <D> )	 pd . cut ( <A> [ <b> ] , <C> , label = <D> ) 
<a> から表データをカンマ区切りで読む	pd . read_csv ( <a> , sep = ',' )	 pd . read_csv ( <a> , sep = ',' ) 
<A> の <b> をビン数を <C> として要素数が等しくなるようにビン分割する	pd . qcut ( <A> [ <b> ] , <C> )	 from pd . qcut ( <A> [ <b> ] , <C> ) 
表データ <D> の <c> が <b> もしくは <a> のデータを抽出する	<D> [ <D> [ <c> ] . isin ( [ <b> , <a> ] ) ]	 isin [ <D> [ <c> ] . isin ( [ <b> , <a> ] ) ] 
表データを <b> から <a> 区切りで読み込み、 <C> とする	<C> = pd . read_csv ( <b> , sep = <a> )	 pd . read_csv ( <b> , sep = <a> ) 
データフレーム <A> の <b> とコラム <c> を消す	<A> . drop ( [ <b> , <c> ] , axis = 1 )	 sns . pairplot ( <A> [ [ <b> , <c> ] ] ) 
表データ <A> 内の <b> を欠損値に置換し、欠損値がある行を落とす	<A> . replace ( <b> , np . nan ) . dropna ( )	 <A> . replace ( <b> , np . nan ) . dropna ( ) 
<D> の表属性 <c> と <b> 表属性と <a> 表属性について関係性を一気に描画する	sns . pairplot ( <D> [ [ <c> , <b> , <a> ] ] )	 pd . merge ( <D> [ <c> , <b> , <a> ] ] ) 
表データ <A> の <b> と列 <c> ごとに <d> の値の合計を計算する	<A> . groupby ( [ <b> , <c> ] ) [ <d> ] . sum ( )	 plt . groupby ( [ <A> [ <b> ] , <c> ] ) [ <d> ] . sum ( ) 
データフレーム <A> のカラム <b> とカラム <c> ごとにカラム <d> の値の和を算出する	<A> . groupby ( [ <b> , <c> ] ) [ <d> ] . sum ( )	 sns . groupby ( [ <A> [ <b> , <c> ] ) [ <d> ] . sum ( ) 
<A> の先頭の <b> 行	<A> . head ( <b> )	 head <A> . head ( <b> ) 
表 <A> 中の欠損を <A> 表の平均値で補う	<A> . fillna ( <A> . mean ( ) )	 <A> . fillna ( <A> . mean ( ) ) 
表 <D> の <c> と <b> と <a> について関係性を一度に描画する	sns . pairplot ( <D> [ [ <c> , <b> , <a> ] ] )	 <D> . pairplot ( [ [ <c> , <b> , <a> ] ] ) 
<a> ファイル名からカンマ区切りで表を読み込み、 <B> とする	<B> = pd . read_csv ( <a> , sep = ',' )	 <B> = pd . read_csv ( <a> , sep = ',' ) 
<B> 内の <a> を欠損に置換し、欠損がある行を落とす	<B> . replace ( <a> , np . nan ) . dropna ( )	 <E> . dropna ( <B> , np . nan ) . dropna ( ) 
<A> の <b> のデータの種類	<A> [ <b> ] . unique ( )	 unique [ <b> ] . unique ( ) 
表 <A> の欠損を <A> データフレームの平均値で補う	<A> . fillna ( <A> . mean ( ) )	 from . mean ( <A> . mean ( ) ) 
ビンのラベルをインデックスとして、 <C> の <b> 列を分割数を <A> 整数値としてビン分割する	pd . cut ( <C> [ <b> ] , <A> , label = False )	 pd . cut ( <C> [ <b> ] , <A> , label = False ) 
<A> のカラム <b> とカラム <c> と <d> について関係性を一気にプロットする	sns . pairplot ( <A> [ [ <b> , <c> , <d> ] ] )	 sns . pairplot ( <A> [ [ <b> , <c> , <d> ] ] ) 
表データ <A> の末尾 <b> 行を調べる	<A> . tail ( <b> )	 <A> . head ( <b> ) 
表 <A> の表属性 <b> についての箱ひげ図を描写する	plt . boxplot ( <A> [ <b> ] )	 <A> [ plt . boxplot ( <b> ] ) 
<B> の <a> のユニークな要素の個数	<B> [ <a> ] . nunique ( )	 <B> [ <a> ] . nunique ( ) 
<C> の <b> 列ごとに <a> の数を数える	<C> . groupby ( [ <b> ] ) [ <a> ] . count ( )	 <A> . groupby ( [ <b> ] ) [ <a> ] . count ( ) 
<E> のカラム <d> 、 <c> 、 <b> 、 <a> を選択する	<E> [ [ <d> , <c> , <b> , <a> ] ]	 <E> [ [ <d> , <c> , <b> , <a> ] ] 
データフレーム <C> の <b> カラムと <a> の相関	<C> [ [ <b> , <a> ] ] . corr ( )	 <A> [ [ <b> , <a> ] ] . corr ( ) 
データフレーム <A> の <b> コラムの各要素の出現頻度	<A> [ <b> ] . value_counts ( )	 from value_counts [ <b> ] . value_counts ( ) 
データフレーム <A> の先頭 5 行を調べる	<A> . head ( )	 head <A> . head ( ) 
<A> のカラム <b> と <c> を削除する	<A> . drop ( [ <b> , <c> ] , axis = 1 )	 sns . pairplot ( <A> [ [ <b> , <c> ] ] ) 
<A> の下 <b> 行	<A> . tail ( <b> )	 <A> . tail ( <b> ) 
ビンのラベルをリスト <D> として、データフレーム <A> の <b> をビン数を <C> として分割する	pd . cut ( <A> [ <b> ] , <C> , label = <D> )	 pd . cut ( <A> [ <b> ] , <C> , label = <D> ) 
表データ <A> の <b> が <c> か <d> のデータを抽出する	<A> [ <A> [ <b> ] . isin ( [ <c> , <d> ] ) ]	 from <A> [ <A> [ <b> ] . isin ( [ <c> , <d> ] ) ] 
x 軸に <a> という軸ラベルを付ける	plt . xlabel ( <a> )	 xlabel . plt ( <a> ) 
位置と <c> を項目名として表データ <A> と <B> を結合する	pd . merge ( <A> , <B> , left_index = True , right_on = <c> )	 . pd ( <A> , <B> , left_index = True , right_on = <c> ) 
列名を指定せずに <a> を読み込む	pd . read_csv ( <a> , header = None )	 pd . read_csv ( <a> , header = None ) 
ビンの名前を整数値として、 <A> の <b> をビン数を <C> 整数値としてビン分割する	pd . cut ( <A> [ <b> ] , <C> , label = False )	 pd . cut ( <A> [ <b> ] , <C> , label = False ) 
<A> の <b> を境界値を <C> として分割する	pd . cut ( <A> [ <b> ] , <C> )	 pd . cut ( <A> [ <b> ] , <C> ) 
位置と <c> を項目名として <A> データフレームと <B> を一つにまとめる	pd . merge ( <A> , <B> , left_index = True , right_on = <c> )	 . pd ( <A> , <B> , left_index = True , right_on = <c> ) 
<A> の表属性 <b> を削除して、再代入する	<A> = <A> . drop ( <b> , axis = 1 )	 <A> = <A> . drop ( <b> , axis = 1 ) 
左外部結合でデータフレーム <B> とデータフレーム <A> をマージする	pd . merge ( <B> , <A> , how = 'left' )	 pd . merge ( <B> , <A> , how = 'left' ) 
表データ <A> の <b> についての要約統計量を見る	<A> [ <b> ] . describe ( )	 <A> [ <b> ] . describe ( ) 
表 <C> の <b> コラムと <a> をドロップする	<C> . drop ( [ <b> , <a> ] , axis = 1 )	 <C> . drop ( [ <b> , <a> ] , axis = 1 ) 
グラフの大きさを横 <b> 縦 <a> とする	plt . figure ( figsize = ( <b> , <a> ) )	 plt . figure ( figsize = ( <a> , <b> ) ) 
表データ <D> の <c> と <b> ごとに <a> の値の和を求める	<D> . groupby ( [ <c> , <b> ] ) [ <a> ] . sum ( )	 <D> . groupby ( [ <c> , <b> ] ) [ <a> ] . sum ( ) 
表 <A> 中の <b> を欠損値に置換し、欠損値が存在する行を削除する	<A> . replace ( <b> , np . nan ) . dropna ( )	 <A> . replace ( <b> , np . nan ) . dropna ( ) 
表データ <A> の <b> を欠損に置換し、欠損がある行を削除する	<A> . replace ( <b> , np . nan ) . dropna ( )	 <A> . replace ( <b> , np . nan ) . dropna ( ) 
表データ <B> と <A> を縦方向でマージする	pd . concat ( [ <B> , <A> ] )	 concat . pd ( [ <B> , <A> ] ) 
<A> の <b> を見る	<A> [ <b> ]	 <A> . head ( <b> ) 
y 軸に <a> というラベルを加える	plt . ylabel ( <a> )	 <E> . ylabel ( <a> ) 
表データ <A> の列 <b> を境界値を <C> リストとしてビン分割する	pd . cut ( <A> [ <b> ] , <C> )	 pd . cut ( <A> [ <b> ] , <C> ) 
表データ <A> の <b> カラムと <c> をドロップする	<A> . drop ( [ <b> , <c> ] , axis = 1 )	 sns . pairplot ( <A> [ [ <b> , <c> ] ] ) 
<A> の <b> 列を分割数を <C> として要素数が等しくなるように分割する	pd . qcut ( <A> [ <b> ] , <C> )	 from pd . qcut ( <A> [ <b> ] , <C> ) 
ビンのラベルを <A> として、 <D> 表の表属性 <c> をビン数を整数値 <B> として分割する	pd . cut ( <D> [ <c> ] , <B> , label = <A> )	 pd . cut ( <D> [ <c> ] , <B> , label = <A> ) 
<E> の列名を <d> から <c> に、 <b> から <a> に変更する	<E> . rename ( columns = { <d> : <c> , <b> : <a> } )	 sns . rename ( columns = { <d> : <c> , <b> : <a> } ) 
全結合で表データ <A> と <B> をマージする	pd . merge ( <A> , <B> , how = 'outer' )	 import . pd ( <A> , <B> , how = 'outer' ) 
表データ <A> の行数と列数	<A> . shape	 <A> . isnull ( ) . sum ( ) 
表 <A> の <b> を落とし、置き換える	<A> . drop ( <b> , axis = 1 , inplace = True )	 <A> = <A> . drop ( <b> , axis = 1 ) 
位置と <c> カラムを項目名として <A> と <B> を一つにまとめる	pd . merge ( <A> , <B> , left_index = True , right_on = <c> )	 . pd ( <A> , <B> , left_index = True , right_on = <c> ) 
<B> 内のそれぞれのカラムにある <a> の個数の合計値	<B> . isin ( [ <a> ] ) . sum ( )	 <B> . isin ( [ <a> ] ) . sum ( ) 
インデックスと表属性 <a> をキーとして <C> データフレームと <B> データフレームをマージする	pd . merge ( <C> , <B> , left_index = True , right_on = <a> )	 pd . merge ( <C> , <B> , left_index = True , right_on = <a> ) 
表データ <D> の <c> 表属性と表属性 <b> と <a> について関係性を一気にプロットする	sns . pairplot ( <D> [ [ <c> , <b> , <a> ] ] )	 pd . merge ( <D> [ <c> , <b> , <a> ] ] ) 
データフレーム <A> 内の NaN を直前の行の値で補う	<A> . fillna ( method = 'ffill' )	 method . fillna ( <A> . method = 'ffill' ) 
<A> の行数と列数	<A> . shape	 <A> . isnull ( ) . sum ( ) 
位置と <c> をキーとして <A> データフレームとデータフレーム <B> を一つにまとめる	pd . merge ( <A> , <B> , left_index = True , right_on = <c> )	 . pd ( <A> , <B> , left_index = True , right_on = <c> ) 
表データ <A> の <b> を削除して、置き換える	<A> . drop ( <b> , axis = 1 , inplace = True )	 <A> = <A> . drop ( <b> , axis = 1 ) 
<B> の <a> をソートする	<B> . sort_values ( <a> )	 import . sort_index ( <a> ) 
インデックスと <a> を項目名として <C> 表と <B> 表をマージする	pd . merge ( <C> , <B> , left_index = True , right_on = <a> )	 pd . merge ( <C> , <B> , left_index = True , right_on = <a> ) 
データフレーム <A> の <b> を分割数を <C> 整数値として要素数が等しくなるようにビン分割する	pd . qcut ( <A> [ <b> ] , <C> )	 pd . qcut ( <A> [ <b> ] , <C> ) 
ファイル <a> から <b> 区切りでデータフレームを読む	pd . read_csv ( <a> , sep = <b> )	 pd . read_csv ( <b> , sep = <a> ) 
棒グラフの位置を真ん中として、 <B> 軸を <B> とした <A> の棒グラフを描写する	plt . bar ( <B> , <A> , align = 'center' )	 pd . merge ( <B> , <A> , align = 'center' ) 
表データ <A> 内の NaN を <A> の平均値で埋める	<A> . fillna ( <A> . mean ( ) )	 <A> . fillna ( <A> . mean ( ) ) 
データフレーム <A> のバリュー	<A> . values	 <A> . values 
<A> の <b> 表属性と <c> の相関	<A> [ [ <b> , <c> ] ] . corr ( )	 <D> [ [ <c> , <b> , <c> ] ] . corr ( ) 
表 <A> の <b> カラムごとにカラム <c> の平均を求める	<A> . groupby ( [ <b> ] ) [ <c> ] . mean ( )	 <A> . groupby ( [ <b> ] ) [ <c> ] . mean ( ) 
<A> の <b> カラムと <c> カラムと <d> について関係性を一気にプロットする	sns . pairplot ( <A> [ [ <b> , <c> , <d> ] ] )	 sns . pairplot ( <A> [ [ <b> , <c> , <d> ] ] ) 
<a> から表データをタブ区切りで読み込む	pd . read_csv ( <a> , sep = '\\\\t' )	 pd . read_csv ( <a> , sep = '\\\\t' ) 
表 <A> の <b> を分割数を整数値 <C> として要素数が等しくなるように分割する	pd . qcut ( <A> [ <b> ] , <C> )	 from pd . qcut ( <A> [ <b> ] , <C> ) 
<D> の表属性 <c> と <b> 表属性と <a> について関係性を一度にプロットする	sns . pairplot ( <D> [ [ <c> , <b> , <a> ] ] )	 <D> . pairplot ( [ [ <c> , <b> , <a> ] ] ) 
表データを <a> 区切りでファイル名 <b> から読む	pd . read_csv ( <b> , sep = <a> )	 pd . read_csv ( <a> , sep = <b> ) 
表データ <B> の最初の <a> 行	<B> . head ( <a> )	 <C> . tail ( <a> ) 
表 <B> の <a> 表属性をドロップし、再代入する	<B> = <B> . drop ( <a> , axis = 1 )	 <B> = <B> . drop ( <a> , axis = 1 ) 
<c> をキーとして、 <A> 表データと表データ <B> を結合する	pd . merge ( <A> , <B> , on = <c> )	 pd . merge ( <A> , <B> , on = <c> ) 
列 <A> の平均値	<A> . mean ( )	 <A> . mean ( ) 
データフレーム <B> の <a> を NaN に置換し、 NaN が存在する行を消す	<B> . replace ( <a> , np . nan ) . dropna ( )	 <E> . dropna ( <B> , np . nan ) . dropna ( ) 
データフレーム <A> のオブジェクトデータの統計情報	<A> . describe ( include = "O" )	 plt . describe ( <A> . describe ( ) 
ビンのラベルを <D> リストとして、表データ <A> の <b> をビン数を <C> としてビン分割する	pd . cut ( <A> [ <b> ] , <C> , label = <D> )	 pd . cut ( <A> [ <b> ] , <C> , label = <D> ) 
ビンの名前を <D> リストとして、データフレーム <A> の <b> をビン数を <C> として分割する	pd . cut ( <A> [ <b> ] , <C> , label = <D> )	 pd . cut ( <A> [ <b> ] , <C> , label = <D> ) 
ビンの名前を <D> リストとして、 <A> の <b> をビン数を整数値 <C> として分割する	pd . cut ( <A> [ <b> ] , <C> , label = <D> )	 pd . cut ( <A> [ <b> ] , <C> , label = <D> ) 
<A> の先頭の <b> 行を確認する	<A> . head ( <b> )	 head <A> . head ( <b> ) 
インデックスと <c> をキーとして <A> 表と <B> をマージする	pd . merge ( <A> , <B> , left_index = True , right_on = <c> )	 . pd ( <A> , <B> , left_index = True , right_on = <c> ) 
<A> の表属性 <b> をグループ化して、値ごとのデータの数を見る	<A> . groupby ( <b> ) . size ( )	 . groupby ( <A> [ <b> ] ) . size ( ) 
表データを <c> 区切りで <b> から読み込み、 <A> とする	<A> = pd . read_csv ( <b> , sep = <c> )	 <A> = pd . read_csv ( <b> , sep = <c> ) 
表 <A> の行の名前を <b> から <c> にリネームする	<A> . rename ( index = { <b> : <c> } )	 <D> . rename ( index = { <b> : <c> } ) 
データフレーム <B> の末尾 <a> 行を調べる	<B> . tail ( <a> )	 import . tail ( <a> ) 
表をパス <a> からカンマ区切りで読んで、 <B> とする	<B> = pd . read_csv ( <a> , sep = ',' )	 <B> = pd . read_csv ( <a> , sep = ',' ) 
表 <D> の <c> と <b> 表属性と <a> について関係性を一気に描画する	sns . pairplot ( <D> [ [ <c> , <b> , <a> ] ] )	 <D> . sns ( [ [ <c> , <b> , <a> ] ] ) 
<B> の表属性 <a> をグループ化して、値ごとのデータの数を見る	<B> . groupby ( <a> ) . size ( )	 <C> . groupby ( <a> ) [ <b> ] . size ( ) 
<C> の <b> 列と <a> を降順にソートする	<C> . sort_values ( [ <b> , <a> ] , ascending = False )	 <A> . sort_values ( [ <b> , <a> ] , ascending = False ) 
タイトルを <a> と設定する	plt . title ( <a> )	 . title ( <a> ) 
ファイル <b> から <c> 区切りで表を読み込み、 <A> に代入する	<A> = pd . read_csv ( <b> , sep = <c> )	 <A> = pd . read_csv ( <b> , sep = <c> ) 
表 <A> 中の NaN を <B> に置き換える	<A> . fillna ( <B> )	 <A> . fillna ( <B> ) 
<c> を項目名として、 <A> と <B> を一つにまとめる	pd . merge ( <A> , <B> , on = <c> )	 pd . merge ( <A> , <B> , on = <c> ) 
<D> の <c> が <b> もしくは <a> のデータを抽出する	<D> [ <D> [ <c> ] . isin ( [ <b> , <a> ] ) ]	 isin [ <D> [ <c> ] . isin ( [ <b> , <a> ] ) ] 
左外部結合で <A> 表データと <B> 表データを一つにまとめる	pd . merge ( <A> , <B> , how = 'left' )	 pd . merge ( <A> , <B> , how = 'left' ) 
グラフの y 軸	x 軸 = x 軸|グラフの x 軸| x 座標	 plt . ylabel ( <a> ) 
表 <A> の <b> コラムのユニークな要素の個数	<A> [ <b> ] . nunique ( )	 nunique <A> [ <b> ] . nunique ( ) 
表データ <A> の <b> を欠損値に置換し、欠損値が存在する行を落とす	<A> . replace ( <b> , np . nan ) . dropna ( )	 <A> . replace ( <b> , np . nan ) . dropna ( ) 
レンジを <b> から <c> として、 <A> のヒストグラムをプロットする	plt . hist ( <A> , range = ( <b> , <c> ) )	 hist plt . hist ( <A> , range = ( <b> , <c> ) ) 
Seaborn ライブラリを <A> としてインポートする	import seaborn as <A>	 sns . import ( <A> ) 
<B> の <a> コラムのユニークな要素数	<B> [ <a> ] . nunique ( )	 <B> [ <a> ] . nunique ( ) 
インデックスと <a> を項目名として表データ <C> と <B> 表データを一つにまとめる	pd . merge ( <C> , <B> , left_index = True , right_on = <a> )	 pd . merge ( <C> , <B> , left_index = True , right_on = <a> ) 
データフレーム <E> の <d> の名前を <c> に、 <b> コラムの名前を <a> にリネームする	<E> . rename ( columns = { <d> : <c> , <b> : <a> } )	 <A> . rename ( columns = { <b> : <c> , <d> : <a> } ) 
<a> を項目名として、 <C> データフレームとデータフレーム <B> を結合する	pd . merge ( <C> , <B> , on = <a> )	 pd . merge ( <C> , <B> , on = <a> ) 
表データ <A> の <b> と <c> と表属性 <d> についての箱ひげ図を描画する	plt . boxplot ( [ <A> [ <b> ] , <A> [ <c> ] , <A> [ <d> ] ] )	 sns . boxplot ( [ <A> [ <b> ] , <A> [ <c> ] , <A> [ <d> ] ] ) 
表データ <A> の <b> 行から <c> 行まで	<A> [ <b> : <c> ]	 <A> [ <b> : <c> ] 
全結合で <B> と <A> 表データを結合する	pd . merge ( <B> , <A> , how = 'outer' )	 pd . merge ( <B> , <A> , how = 'outer' ) 
表 <B> の <a> カラムを削除し、インプレースする	<B> . drop ( <a> , axis = 1 , inplace = True )	 <E> . drop ( <B> , axis = 1 , inplace = True ) 
<B> と <A> の散布図を描画する	plt . scatter ( <B> , <A> )	 scatter plt . scatter ( <B> , <A> ) 
表 <A> 内の <b> を欠損値に置換し、欠損値がある行を削除する	<A> . replace ( <b> , np . nan ) . dropna ( )	 <A> . replace ( <b> , np . nan ) . dropna ( ) 
表 <B> 中のそれぞれのカラムに存在する <a> の個数の合計値	<B> . isin ( [ <a> ] ) . sum ( )	 <B> . isin ( [ <a> ] ) . sum ( ) 
表 <D> の <c> と <b> と <a> 表属性について関係性を一気に描写する	sns . pairplot ( <D> [ [ <c> , <b> , <a> ] ] )	 <D> . sns ( [ [ <c> , <b> , <a> ] ] ) 
表データ <A> の <b> 行	<A> . head ( <b> )	 <A> [ <b> ] . head ( ) 
データフレーム <D> の <c> と <b> と <a> 列について関係性を一気に描く	sns . pairplot ( <D> [ [ <c> , <b> , <a> ] ] )	 <D> . pairplot ( [ [ <c> , <b> , <a> ] ] ) 
<C> の列 <b> を分割数を <A> 整数値として要素数が等しくなるようにビン分割する	pd . qcut ( <C> [ <b> ] , <A> )	 pd . qcut ( <C> [ <b> ] , <A> ) 
<B> と <A> 表データを結合する	pd . merge ( <B> , <A> )	 <B> . pd ( <A> ) 
区関の数を <b> として、 <A> のヒストグラムをプロットする	plt . hist ( <A> , bins = <b> )	 sns . hist ( <A> , bins = <b> ) 
表データ <D> の <c> が <b> か <a> のデータを抽出する	<D> [ <D> [ <c> ] . isin ( [ <b> , <a> ] ) ]	 isin [ <D> [ <c> ] . isin ( [ <b> , <a> ] ) ] 
表を <a> ファイルパスからタブ区切りで読む	pd . read_csv ( <a> , sep = '\\\\t' )	 pd . read_csv ( <a> , sep = '\\\\t' ) 
表データ <C> の <b> と <a> 表属性を降順にソートする	<C> . sort_values ( [ <b> , <a> ] , ascending = False )	 <E> . sort_values ( [ <b> , <a> ] , ascending = False ) 
表 <A> のコラム <b> とコラム <c> を降順にソートする	<A> . sort_values ( [ <b> , <c> ] , ascending = False )	 sns . sort_values ( <A> [ <b> , <c> ] , ascending = False ) 
<A> の NaN が存在する行を削除する	<A> . dropna ( )	 <A> . dropna ( ) 
データフレーム <A> の末尾の 5 行を確認する	<A> . tail ( )	 <A> . tail ( ) 
表 <D> の <c> と <b> ごとに <a> の値の和を求める	<D> . groupby ( [ <c> , <b> ] ) [ <a> ] . sum ( )	 <D> . groupby ( [ <c> , <b> ] ) [ <a> ] . sum ( ) 
表データ <A> の <b> を分割数を整数値 <C> として分割する	pd . cut ( <A> [ <b> ] , <C> )	 pd . cut ( <A> [ <b> ] , <C> ) 
データフレーム <A> の形状	<A> . shape	 from ) 
表データ <A> の欠損を <B> とする	<A> . fillna ( <B> )	 <A> . fillna ( <B> ) 
表 <A> の <b> をビン数を <C> 整数値として要素数が等しくなるようにビン分割する	pd . qcut ( <A> [ <b> ] , <C> )	 pd . qcut ( <A> [ <b> ] , <C> ) 
データフレーム <A> の <b> 列と <c> の相関係数	<A> [ [ <b> , <c> ] ] . corr ( )	 <D> [ [ <c> , <b> , <c> ] ] . corr ( ) 
<C> のカラム <b> と <a> の相関	<C> [ [ <b> , <a> ] ] . corr ( )	 <E> [ [ <b> , <a> ] ] . corr ( ) 
ビンのラベルをインデックスとして、 <C> の <b> をビン数を <A> としてビン分割する	pd . cut ( <C> [ <b> ] , <A> , label = False )	 pd . cut ( <C> [ <b> ] , <A> , label = False ) 
表データ <B> の <a> 列のバリュー	<B> [ <a> ] . values	 <B> [ <a> ] . values 
グリッドをグラフに付ける	plt . grid ( True )	 軸 . grid ( True ) 
<b> から表を <a> 区切りで読み込んで、 <C> とする	<C> = pd . read_csv ( <b> , sep = <a> )	 pd . read_csv ( <b> , sep = <a> ) 
<A> の表属性 <b> が <c> もしくは <d> のデータを抽出する	<A> [ <A> [ <b> ] . isin ( [ <c> , <d> ] ) ]	 <A> [ <A> [ <b> ] . isin ( [ <c> , <d> ] ) ] 
<b> 区切りでファイル名 <a> からデータフレームを読む	pd . read_csv ( <a> , sep = <b> )	 pd . read_csv ( <b> , sep = <a> ) 
データフレーム <C> の <b> 表属性と表属性 <a> を降順にソートする	<C> . sort_values ( [ <b> , <a> ] , ascending = False )	 <E> . sort_values ( [ <b> , <a> ] , ascending = False ) 
全結合で <B> と表 <A> をマージする	pd . merge ( <B> , <A> , how = 'outer' )	 pd . merge ( <B> , <A> , how = 'outer' ) 
区関の数を <a> として、 <B> のヒストグラムをプロットする	plt . hist ( <B> , bins = <a> )	 sns . hist ( <B> , bins = <a> ) 
<A> の表属性 <b> をドロップする	<A> . drop ( <b> , axis = 1 )	 plt . dropna ( ) 
表データを <a> からカンマ区切りで読んで、 <B> にする	<B> = pd . read_csv ( <a> , sep = ',' )	 <B> = pd . read_csv ( <a> , sep = ',' ) 
<a> から <b> 区切りでデータフレームを読み込む	pd . read_csv ( <a> , sep = <b> )	 pd . read_csv ( <b> , sep = <a> ) 
ビンの名前を整数値として、 <C> データフレームの <b> 表属性をビン数を整数値 <A> として分割する	pd . cut ( <C> [ <b> ] , <A> , label = False )	 pd . cut ( <C> [ <b> ] , <A> , label = False ) 
表属性 <A> の中央値を見る	<A> . median ( )	 <A> . median ( ) 
データフレーム <B> の <a> をインデックスとして設定する	<B> . set_index ( <a> )	 <B> . set_index ( <a> ) 
表 <A> の <b> 表属性の一意の値	<A> [ <b> ] . unique ( )	 軸 [ <b> ] . unique ( ) 
表データ <A> の表属性 <b> が <c> より少ないデータを抽出する	<A> [ <A> [ <b> ] <  <c> ]	 plt . boxplot ( <A> [ <b> ] , <A> [ <c> ] ) ] 
<a> を <b> 区切りで読み込む	pd . read_csv ( <a> , sep = <b> )	 pd . read_csv ( <b> , sep = <a> ) 
表データ <B> の最初から <a> 行目まで	<B> [ : <a> ]	 <B> [ : <a> ] 
データフレーム <A> 中の <b> を欠損値に置換し、欠損値がある行を消す	<A> . replace ( <b> , np . nan ) . dropna ( )	 <A> . replace ( <b> , np . nan ) . dropna ( ) 
表 <C> の <b> と列 <a> の相関	<C> [ [ <b> , <a> ] ] . corr ( )	 <C> [ [ <b> , <a> ] ] . corr ( ) 
ビンのラベルを 0 始まりの連番として、表データ <A> の <b> をビン数を整数値 <C> として分割する	pd . cut ( <A> [ <b> ] , <C> , label = False )	 pd . cut ( <A> [ <b> ] , <C> , label = False ) 
表 <A> の下 <b> 行を表示する	<A> . tail ( <b> )	 <A> . tail ( <b> ) 
<B> の <a> コラムについての分散	<B> [ <a> ] . var ( )	 <B> [ <a> ] . var ( ) 
表データ <A> のカラム <b> 、 <c> 、 <d>	<A> [ [ <b> , <c> , <d> ] ]	 [ <A> [ <b> , <c> , <d> ] ] 
表 <A> 中の欠損値の数	<A> . isnull ( ) . sum ( )	 <A> . isnull ( ) . sum ( ) 
<A> の列 <b> を消す	<A> . drop ( <b> , axis = 1 )	 <A> . drop ( <b> , axis = 1 ) 
表 <B> のコラム <a> を消し、置き換える	<B> . drop ( <a> , axis = 1 , inplace = True )	 <B> = <B> . drop ( <a> , axis = 1 ) 
<A> の末尾の 5 行	<A> . tail ( )	 <A> . tail ( ) 
ビンの名前を <A> リストとして、表データ <D> の <c> をビン数を <B> 整数値としてビン分割する	pd . cut ( <D> [ <c> ] , <B> , label = <A> )	 pd . cut ( <D> [ <c> ] , <B> , label = <A> ) 
表データ <B> の <a> をソートする	<B> . sort_values ( <a> )	 <B> . sort_values ( <a> ) 
<B> の <a> を落として、置き換える	<B> = <B> . drop ( <a> , axis = 1 )	 <B> = <B> . drop ( <a> , axis = 1 ) 
データフレーム <B> の <a> についてのヒストグラムを表示する	plt . hist ( <B> [ <a> ] )	 <B> [ <a> ] . hist ( ) 
<A> の列 <b> を境界値をリスト <C> としてビン分割する	pd . cut ( <A> [ <b> ] , <C> )	 pd . cut ( <A> [ <b> ] , <C> ) 
<A> の列名を <b> から <c> にリネームする	<A> . rename ( columns = { <b> : <c> } )	 <A> . rename ( columns = { <b> : <c> } ) 
ビンの名前をリスト <A> として、 <D> データフレームのカラム <c> をビン数を <B> として分割する	pd . cut ( <D> [ <c> ] , <B> , label = <A> )	 pd . cut ( <D> [ <c> ] , <B> , label = <A> ) 
表 <C> の列 <b> を境界値を <A> リストとしてビン分割する	pd . cut ( <C> [ <b> ] , <A> )	 pd . cut ( <C> [ <b> ] , <A> ) 
全結合で <B> と <A> 表を一つにまとめる	pd . merge ( <B> , <A> , how = 'outer' )	 . pd ( <B> , <A> , how = 'outer' ) 
<a> からデータフレームをタブ区切りで読み、 <B> とする	<B> = pd . read_csv ( <a> , sep = '\\\\t' )	 pd . read_csv ( <a> , sep = '\\\\t' ) 
データフレーム <A> 中の NaN を <A> 表データの平均値で埋める	<A> . fillna ( <A> . mean ( ) )	 <A> . fillna ( <A> . mean ( ) ) 
表 <D> の <c> コラムと <b> とコラム <a> について関係性を一度にプロットする	sns . pairplot ( <D> [ [ <c> , <b> , <a> ] ] )	 <D> . sns ( [ [ <c> , <b> , <a> ] ] ) 
ビンの名前を 0 始まりの連番として、 <A> の <b> を分割数を <C> として分割する	pd . cut ( <A> [ <b> ] , <C> , label = False )	 pd . cut ( <A> [ <b> ] , <C> , label = False ) 
データフレームをカンマ区切りで <a> ファイルから読み込む	pd . read_csv ( <a> , sep = ',' )	 pd . read_csv ( <a> , sep = ',' ) 
表 <B> 内の <a> を欠損値に置換し、欠損値がある行を落とす	<B> . replace ( <a> , np . nan ) . dropna ( )	 <E> . dropna ( <B> , np . nan ) . dropna ( ) 
データフレーム <A> の欠損値を直前の行の値で埋める	<A> . fillna ( method = 'ffill' )	 method . fillna ( <A> . method = 'ffill' ) 
データフレームをカンマ区切りで <b> から読んで、 <A> とする	<A> = pd . read_csv ( <b> , sep = ',' )	 <A> = pd . read_csv ( <b> , sep = ',' ) 
表データ <B> の <a> についての箱ひげ図を描写する	plt . boxplot ( <B> [ <a> ] )	 plt . boxplot ( <B> [ <a> ] ) 
凡例をグラフ内の最適な位置に加える	plt . legend ( loc = 'best' )	 sns . legend ( loc = 'best' ) 
表データ <A> の末尾の <b> 行	<A> . tail ( <b> )	 <A> [ <b> ] . tail ( ) 
<A> の <b> コラムとコラム <c> と <d> について関係性を一気に描画する	sns . pairplot ( <A> [ [ <b> , <c> , <d> ] ] )	 . pairplot ( <A> [ [ <b> , <c> , <d> ] ] ) 
データフレーム <B> の末尾の <a> 行	<B> . tail ( <a> )	 import . tail ( <a> ) 
表データ <D> の <c> 表属性と <b> と表属性 <a> についての箱ひげ図を描写する	plt . boxplot ( [ <D> [ <c> ] , <D> [ <b> ] , <D> [ <a> ] ] )	 sns . boxplot ( [ <D> [ <c> ] , <D> [ <b> ] , <D> [ <a> ] ] ) 
データフレーム <A> の <b> を欠損値に置換し、欠損値が存在する行をドロップする	<A> . replace ( <b> , np . nan ) . dropna ( )	 <A> . replace ( <b> , np . nan ) . dropna ( ) 
表データ <B> の <a> コラムを位置に設定する	<B> . set_index ( <a> )	 <E> . set_index ( <B> [ <a> ] ) 
<B> の <a> 行から最後まで	<B> [ <a> : ]	 <B> [ <a> : ] 
位置と <c> をキーとして表データ <A> と <B> をマージする	pd . merge ( <A> , <B> , left_index = True , right_on = <c> )	 . pd ( <A> , <B> , left_index = True , right_on = <c> ) 
<c> をキーとして、 <A> と <B> 表をマージする	pd . merge ( <A> , <B> , on = <c> )	 pd . merge ( <A> , <B> , on = <c> ) 
<B> の <a> 列を datetime 型に変換する	pd . to_datetime ( <B> [ <a> ] , format = '%Y-%m-%d' )	 pd . to_datetime ( <B> [ <a> ] , format = '%Y-%m-%d' ) 
ピボット操作でデータフレーム <A> の行を列に変更する	<A> . unstack ( )	 <A> . stack ( ) 
ビンのラベルをインデックスとして、 <A> の <b> をビン数を <C> としてビン分割する	pd . cut ( <A> [ <b> ] , <C> , label = False )	 pd . cut ( <A> [ <b> ] , <C> , label = False ) 
表 <D> の <c> カラムと <b> ごとに <a> の値の合計値を算出する	<D> . groupby ( [ <c> , <b> ] ) [ <a> ] . sum ( )	 <D> . groupby ( [ <c> , <b> ] ) [ <a> ] . sum ( ) 
表データ <C> のインデックス名を <b> から <a> に変更する	<C> . rename ( index = { <b> : <a> } )	 <E> . rename ( index = { <b> : <a> } ) 
<a> から表をタブ区切りで読み込んで、 <B> にする	<B> = pd . read_csv ( <a> , sep = '\\\\t' )	 pd . read_csv ( <a> , sep = '\\\\t' ) 
カンマ区切りで表データをファイル名 <a> から読み込む	pd . read_csv ( <a> , sep = ',' )	 pd . read_csv ( <a> , sep = ',' ) 
データフレーム <B> の <a> 行	<B> . head ( <a> )	 <A> . head ( <a> ) 
表 <B> の先頭から <a> 行まで	<B> [ : <a> ]	 : <B> [ <a> ] 
ビンの名前を <D> リストとして、 <A> 表データの <b> をビン数を整数値 <C> としてビン分割する	pd . cut ( <A> [ <b> ] , <C> , label = <D> )	 <A> . pd ( [ <b> ] , <C> , label = <D> ) 
<D> のカラム <c> とカラム <b> と <a> について関係性を一気にプロットする	sns . pairplot ( <D> [ [ <c> , <b> , <a> ] ] )	 <D> [ [ <c> , <b> , <a> ] ] . pairplot ( ) 
表データ <A> の最初の <b> 行	<A> . head ( <b> )	 <A> . head ( <b> ) 
<B> の末尾の <a> 行を表示する	<B> . tail ( <a> )	 import . tail ( <a> ) 
左外部結合で <A> と <B> データフレームを結合する	pd . merge ( <A> , <B> , how = 'left' )	 pd . merge ( <A> , <B> , how = 'left' ) 
データフレーム <D> の <c> 表属性と表属性 <b> と <a> についての箱ひげ図をプロットする	plt . boxplot ( [ <D> [ <c> ] , <D> [ <b> ] , <D> [ <a> ] ] )	 sns . boxplot ( [ <D> [ <c> ] , <D> [ <b> ] , <D> [ <a> ] ] ) 
表 <B> の <a> 列の出現回数	<B> [ <a> ] . value_counts ( )	 <B> [ <a> ] . value_counts ( ) 
全結合で <B> と <A> を一つにまとめる	pd . merge ( <B> , <A> , how = 'outer' )	 . pd ( <B> , <A> , how = 'outer' ) 
表データ <A> 中の <b> を欠損値に置換し、欠損値が存在する行を落とす	<A> . replace ( <b> , np . nan ) . dropna ( )	 <A> . replace ( <b> , np . nan ) . dropna ( ) 
左外部結合でデータフレーム <B> と <A> データフレームを一つにまとめる	pd . merge ( <B> , <A> , how = 'left' )	 . pd ( <B> , <A> , how = 'left' ) 
<A> の <b> 表属性と <c> ごとに <d> の値の合計値を算出する	<A> . groupby ( [ <b> , <c> ] ) [ <d> ] . sum ( )	 sns . groupby ( [ <A> [ <b> , <c> ] ) [ <d> ] . sum ( ) 
表 <B> の <a> を datetime 型に変換する	pd . to_datetime ( <B> [ <a> ] , format = '%Y-%m-%d' )	 pd . to_datetime ( <B> [ <a> ] , format = '%Y-%m-%d' ) 
表 <A> の <b> 表属性をドロップし、再代入する	<A> = <A> . drop ( <b> , axis = 1 )	 <A> = <A> . drop ( <b> , axis = 1 ) 
<A> の NaN を含む行をドロップする	<A> . dropna ( )	 <A> . dropna ( ) 
表データ <A> の <b> カラムをインデックスとして設定する	<A> . set_index ( <b> )	 <A> . set_index ( <b> ) 
カンマ区切りで <a> を読み込んで、 <B> に代入する	<B> = pd . read_csv ( <a> , sep = ',' )	 <B> = pd . read_csv ( <a> , sep = ',' ) 
位置と列 <c> をキーとして <A> 表と <B> をマージする	pd . merge ( <A> , <B> , left_index = True , right_on = <c> )	 . pd ( <A> , <B> , left_index = True , right_on = <c> ) 
全結合で <A> と表 <B> を結合する	pd . merge ( <A> , <B> , how = 'outer' )	 . pd ( <A> , <B> , how = 'outer' ) 
データフレーム <A> 中の欠損値を直前の行の値で埋める	<A> . fillna ( method = 'ffill' )	 method . fillna ( <A> . method = 'ffill' ) 
データフレーム <A> 中に存在する <b> を欠損とする	<A> . replace ( <b> , np . nan )	 plt . dropna ( <A> ) 
全結合で <A> 表と <B> 表を一つにまとめる	pd . merge ( <A> , <B> , how = 'outer' )	 . pd ( <A> , <B> , how = 'outer' ) 
<A> 内の欠損を表データ <A> の平均値で補う	<A> . fillna ( <A> . mean ( ) )	 <A> . fillna ( <A> . mean ( ) ) 
ヘッダーを指定せずに <a> ファイル名を読む	pd . read_csv ( <a> , header = None )	 pd . read_csv ( <a> , header = None ) 
全結合で <B> とデータフレーム <A> を結合する	pd . merge ( <B> , <A> , how = 'outer' )	 pd . merge ( <B> , <A> , how = 'outer' ) 
<C> の <b> ごとに <a> の数をカウントする	<C> . groupby ( [ <b> ] ) [ <a> ] . count ( )	 <A> . groupby ( [ <b> ] ) [ <a> ] . count ( ) 
棒グラフの位置を真ん中として、 <B> 軸を <B> とした <A> の棒グラフを表示する	plt . barh ( <B> , <A> , align = 'center' )	 pd . merge ( <B> , <A> , align = 'center' ) 
表データ <A> の <b> 行から末尾まで	<A> [ <b> : ]	 <A> [ <b> : ] 
表 <B> と表 <A> を縦方向でマージする	pd . concat ( [ <B> , <A> ] )	 concat . pd ( [ <B> , <A> ] ) 
<A> についてダミー変数を生成する	pd . get_dummies ( <A> )	 pd . get_dummies ( <A> ) 
データフレーム <B> のコラム <a> 中の前後の行の差分を算出	<B> [ <a> ] . diff ( periods = 1 )	 <B> [ <a> ] . diff ( periods = 1 ) 
表 <A> の <b> をドロップする	<A> . drop ( [ <b> ] )	 pd . drop ( <A> [ <b> ] ) 
データフレーム <A> の <b> と列 <c> と <d> について関係性を一度にプロットする	sns . pairplot ( <A> [ [ <b> , <c> , <d> ] ] )	 sns . pairplot ( <A> [ [ <b> , <c> , <d> ] ] ) 
値のレンジを <b> から <a> として、 <C> のヒストグラムを表示する	plt . hist ( <C> , range = ( <b> , <a> ) )	 sns . hist ( <C> , range = ( <b> , <a> ) ) 
<B> の <c> を削除して、 <A> とする	<A> = <B> . drop ( <c> , axis = 1 )	 <B> = <B> . drop ( <c> , axis = 1 ) 
<B> のそれぞれのカラムにある <a> の個数の合計値を表示する	<B> . isin ( [ <a> ] ) . sum ( )	 <B> . isin ( [ <a> ] ) . sum ( ) 
<A> の <b> カラムが <c> より大きいデータを抽出する	<A> [ <A> [ <b> ] >  <c> ]	 plt . boxplot ( [ <A> [ <b> ] , <A> [ <c> ] ) ] 
グラフの色を <C> として、 <A> と <B> のグラフをプロットする	plt . plot ( <A> , <B> , color = ( <C> ) )	 pd . plot ( <A> , <B> , color = ( <C> ) ) 
ビンのラベルを <A> として、 <D> の <c> を分割数を <B> 整数値としてビン分割する	pd . cut ( <D> [ <c> ] , <B> , label = <A> )	 pd . cut ( <D> [ <c> ] , <B> , label = <A> ) 
データフレーム <A> の <b> の名前を <c> にリネームする	<A> . rename ( columns = { <b> : <c> } )	 <A> . rename ( columns = { <b> : <c> } ) 
<A> の <b> コラムを四分位数ごとで分割する	pd . qcut ( <A> [ <b> ] , 4 )	 pd . qcut ( <A> [ <b> ] , 4 ) 
表データ <B> の <a> カラム内の前後の行の差分を計算	<B> [ <a> ] . diff ( periods = 1 )	 <B> [ <a> ] . diff ( periods = 1 ) 
表 <A> に存在する <b> を NaN とする	<A> . replace ( <b> , np . nan )	 <A> . replace ( <b> , np . nan ) 
<B> の <a> をドロップして、置き換える	<B> = <B> . drop ( <a> , axis = 1 )	 <B> = <B> . drop ( <a> , axis = 1 ) 
表データ <B> の最初から <a> 行まで	<B> [ : <a> ]	 <B> [ : <a> ] 
表データ <B> とデータフレーム <A> を一つにまとめる	pd . merge ( <B> , <A> )	 <B> pd . merge ( <A> , <B> ) 
ビンのラベルをリスト <D> として、 <A> の <b> をビン数を <C> として分割する	pd . cut ( <A> [ <b> ] , <C> , label = <D> )	 pd . cut ( <A> [ <b> ] , <C> , label = <D> ) 
表データ <C> のカラム <b> と <a> を抽出する	<C> [ [ <b> , <a> ] ]	 sns . pairplot ( <C> [ [ <b> , <a> <a> ] ] ) 
データフレーム <B> の <a> のそれぞれのデータの出現回数	<B> [ <a> ] . value_counts ( )	 <B> [ <a> ] . value_counts ( ) 
データフレーム <A> の列の名前を <b> から <c> に、 <d> から <e> に変更する	<A> . rename ( columns = { <b> : <c> , <d> : <e> } )	 <A> . rename ( columns = { <b> : <c> , <d> : <e> } ) 
ビンの名前を <A> として、 <D> の <c> を分割数を <B> 整数値として分割する	pd . cut ( <D> [ <c> ] , <B> , label = <A> )	 pd . cut ( <D> [ <c> ] , <B> , label = <A> ) 
表データ <D> の <c> コラムと <b> ごとに <a> の値の合計値を算出する	<D> . groupby ( [ <c> , <b> ] ) [ <a> ] . sum ( )	 <D> . groupby ( [ <c> , <b> ] ) [ <a> ] . sum ( ) 
ラベルを <c> として、 <A> と <B> の折れ線グラフを描く	plt . plot ( <A> , <B> , label = <c> )	 pd . merge ( <A> , <B> , label = <c> ) 
データフレーム <B> の <a> 表属性についての箱ひげ図をプロットする	plt . boxplot ( <B> [ <a> ] )	 boxplot plt . boxplot ( <B> [ <a> ] ) 
データフレーム <C> の <b> カラムと <a> の相関係数	<C> [ [ <b> , <a> ] ] . corr ( )	 <A> [ [ <b> , <a> ] ] . corr ( ) 
データフレーム <A> の <b> を分割数を <C> 整数値として要素数が等しくなるように分割する	pd . qcut ( <A> [ <b> ] , <C> )	 pd . qcut ( <A> [ <b> ] , <C> ) 
ファイル <b> から <a> 区切りで表を読み込み、 <C> に代入する	<C> = pd . read_csv ( <b> , sep = <a> )	 <E> = pd . read_csv ( <b> , sep = <a> ) 
データフレーム <A> の <b> と <c> と列 <d> についての箱ひげ図をプロットする	plt . boxplot ( [ <A> [ <b> ] , <A> [ <c> ] , <A> [ <d> ] ] )	 sns . boxplot ( [ <A> [ <b> ] , <A> [ <c> ] , <A> [ <d> ] ] ) 
ビンのラベルを 0 始まりの連番として、表 <A> の <b> をビン数を <C> としてビン分割する	pd . cut ( <A> [ <b> ] , <C> , label = False )	 pd . cut ( <A> [ <b> ] , <C> , label = False ) 
位置と <c> をキーとして表 <A> と表 <B> を一つにまとめる	pd . merge ( <A> , <B> , left_index = True , right_on = <c> )	 . pd ( <A> , <B> , left_index = True , right_on = <c> ) 
<A> の <b> の名前を <c> にリネームする	<A> . rename ( index = { <b> : <c> } )	 <D> . rename ( columns = { <b> : <c> } ) 
表 <B> の <a> についてのヒストグラムを表示する	plt . hist ( <B> [ <a> ] )	 <B> [ <a> ] . hist ( ) 
<A> の <b> と <c> ごとに <d> の値の合計値を算出する	<A> . groupby ( [ <b> , <c> ] ) [ <d> ] . sum ( )	 sns . groupby ( [ <A> [ <b> , <c> ] ) [ <d> ] . sum ( ) 
位置と <c> コラムを項目名として <A> と <B> をマージする	pd . merge ( <A> , <B> , left_index = True , right_on = <c> )	 . pd ( <A> , <B> , left_index = True , right_on = <c> ) 
表 <B> の <a> のそれぞれのデータの出現頻度	<B> [ <a> ] . value_counts ( )	 <B> [ <a> ] . value_counts ( ) 
表属性 <A> の平均値	<A> . mean ( )	 sns . mean ( <A> . mean ( ) ) 
<E> のうち、 <d> , <c> , <b> 行目の <a> , <c> 列目を取得	<E> . iloc [ [ <d> , <c> , <b> ] , [ <a> , <c> ] ]	 sns . pairplot ( <D> [ [ <c> , <b> , <a> ] ] ) 
<A> の <b> と <c> コラムごとに <d> の値の合計値を計算する	<A> . groupby ( [ <b> , <c> ] ) [ <d> ] . sum ( )	 sns . groupby ( [ <A> [ <b> , <c> ] ) [ <d> ] . sum ( ) 
全結合で <B> 表と <A> 表を一つにまとめる	pd . merge ( <B> , <A> , how = 'outer' )	 . pd ( <B> , <A> , how = 'outer' ) 
ビンの名前を <A> リストとして、 <D> の <c> をビン数を整数値 <B> としてビン分割する	pd . cut ( <D> [ <c> ] , <B> , label = <A> )	 pd . cut ( <D> [ <c> ] , <B> , label = <A> ) 
データフレーム <A> の <b> を NaN に置換し、 NaN がある行をドロップする	<A> . replace ( <b> , np . nan ) . dropna ( )	 <A> . replace ( <b> , np . nan ) . dropna ( ) 
<b> を <a> 区切りで読む	pd . read_csv ( <b> , sep = <a> )	 pd . read_csv ( <a> , sep = <b> ) 
データフレーム <A> の <b> と <c> コラムと <d> について関係性を一気に描画する	sns . pairplot ( <A> [ [ <b> , <c> , <d> ] ] )	 . pairplot ( <A> [ [ <b> , <c> , <d> ] ] ) 
表 <A> の <b> 表属性の名前を <c> に変更する	<A> . rename ( columns = { <b> : <c> } )	 <A> . rename ( columns = { <b> : <c> } ) 
表 <B> の <a> についてのヒストグラムをプロットする	plt . hist ( <B> [ <a> ] )	 <B> [ <a> ] . hist ( ) 
データフレーム <A> の <b> と <c> と <d> 列について関係性を一気に描く	sns . pairplot ( <A> [ [ <b> , <c> , <d> ] ] )	 . pairplot ( <A> [ [ <b> , <c> , <d> ] ] ) 
表 <A> 中の <b> を NaN に置換し、 NaN がある行を削除する	<A> . replace ( <b> , np . nan ) . dropna ( )	 <A> . replace ( <b> , np . nan ) . dropna ( ) 
表 <A> の <b> 列を選択する	<A> [ <b> ]	 sns . pairplot ( <A> [ <b> ] ) 
データフレーム <A> 中のそれぞれのカラムに存在する <b> の個数の合計値を見る	<A> . isin ( [ <b> ] ) . sum ( )	 <D> . groupby ( [ <c> , <b> ] ) . sum ( ) 
<a> ファイル名から表をタブ区切りで読む	pd . read_csv ( <a> , sep = '\\\\t' )	 pd . read_csv ( <a> , sep = '\\\\t' ) 
表 <A> のカラム <b> 、 <c> 、 <d> を見る	<A> [ [ <b> , <c> , <d> ] ]	 sns . pairplot ( <A> [ [ <b> , <c> , <d> ] ] ) 
Seaborn をインポートする	import seaborn as sns	 import seaborn as sns 
<A> の <b> コラムを四分位数ごとでビン分割する	pd . qcut ( <A> [ <b> ] , 4 )	 pd . qcut ( <A> [ <b> ] , 4 ) 
表データ <A> の <b> のユニークな要素の個数	<A> [ <b> ] . nunique ( )	 nunique <A> [ <b> ] . nunique ( ) 
表データ <A> の <b> 列をインデックスとして設定する	<A> . set_index ( <b> )	 <A> . set_index ( <b> ) 
データフレーム <B> の <a> を消して、再代入する	<B> = <B> . drop ( <a> , axis = 1 )	 <B> = <B> . drop ( <a> , axis = 1 ) 
データフレーム <A> のコラム <b> の名前を <c> に、 <d> の名前を <e> にリネームする	<A> . rename ( columns = { <b> : <c> , <d> : <e> } )	 <A> . rename ( columns = { <b> : <c> , <d> : <e> } ) 
表 <B> の <a> 表属性についての標準偏差	<B> [ <a> ] . std ( )	 <B> [ <a> ] . std ( ) 
<B> と <A> を縦方向でマージする	pd . concat ( [ <B> , <A> ] )	 concat . pd ( [ <B> , <A> ] ) 
データフレーム <A> の <b> とカラム <c> とカラム <d> について関係性を一気に描写する	sns . pairplot ( <A> [ [ <b> , <c> , <d> ] ] )	 sns . pairplot ( <A> [ [ <b> , <c> , <d> ] ] ) 
表データ <A> の列 <b> のバリュー	<A> [ <b> ] . values	 <A> [ <b> ] . values 
表データ <A> の欠損が存在する行を落とす	<A> . dropna ( )	 <A> . dropna ( ) 
データフレーム <B> 内のそれぞれのカラムにある <a> の個数の合計値	<B> . isin ( [ <a> ] ) . sum ( )	 plt . isin ( <B> [ <a> ] ) . sum ( ) 
表 <D> の <c> と <b> とカラム <a> についての箱ひげ図を描画する	plt . boxplot ( [ <D> [ <c> ] , <D> [ <b> ] , <D> [ <a> ] ] )	 sns . boxplot ( [ <D> [ <c> ] , <D> [ <b> ] , <D> [ <a> ] ] ) 
インデックスとカラム <a> をキーとして <C> データフレームと <B> を一つにまとめる	pd . merge ( <C> , <B> , left_index = True , right_on = <a> )	 pd . merge ( <C> , <B> , left_index = True , right_on = <a> ) 
ビンの名前を 0 始まりの連番として、 <C> の <b> を分割数を <A> 整数値として分割する	pd . cut ( <C> [ <b> ] , <A> , label = False )	 pd . cut ( <C> [ <b> ] , <A> , label = False ) 
位置と <a> を項目名として <C> と表データ <B> を結合する	pd . merge ( <C> , <B> , left_index = True , right_on = <a> )	 . pd ( <C> , <B> , left_index = True , right_on = <a> ) 
色を <A> として、 <C> と <B> の折れ線グラフをプロットする	plt . plot ( <C> , <B> , color = ( <A> ) )	 pd . merge ( <A> , <B> , color = ( <C> ) ) 
<A> の <b> とカラム <c> とカラム <d> について関係性を一気に描画する	sns . pairplot ( <A> [ [ <b> , <c> , <d> ] ] )	 sns . pairplot ( <A> [ [ <b> , <c> , <d> ] ] ) 
左外部結合で <A> 表データと <B> 表データを結合する	pd . merge ( <A> , <B> , how = 'left' )	 <A> . pd ( <B> , how = 'left' ) 
表データ <A> の <b> 表属性と <c> を降順に並び替える	<A> . sort_values ( [ <b> , <c> ] , ascending = False )	 . sort_values ( [ <A> , <b> ] , ascending = False ) 
データフレーム <B> の <a> をドロップする	<B> . drop ( <a> , axis = 1 )	 <B> . drop ( [ <a> ] ) 
<D> の <c> と <b> ごとに <a> の値の合計値を計算する	<D> . groupby ( [ <c> , <b> ] ) [ <a> ] . sum ( )	 <D> . groupby ( [ <c> , <b> ] ) [ <a> ] . sum ( ) 
表 <A> の <b> 表属性をビン数を <C> 整数値として分割する	pd . cut ( <A> [ <b> ] , <C> )	 pd . cut ( <A> [ <b> ] , <C> ) 
データフレーム <B> の <a> 列を年月日の形式に変換する	pd . to_datetime ( <B> [ <a> ] , format = '%Y-%m-%d' )	 pd . to_datetime ( <B> [ <a> ] , format = '%Y-%m-%d' ) 
表 <C> のコラム <b> とコラム <a> を降順にソートする	<C> . sort_values ( [ <b> , <a> ] , ascending = False )	 <E> . sort_values ( [ <b> , <a> ] , ascending = False ) 
<A> の <b> の出現頻度	<A> [ <b> ] . value_counts ( )	 <A> [ <b> ] . value_counts ( ) 
ファイル名 <a> からカンマ区切りでデータフレームを読み込んで、 <B> とする	<B> = pd . read_csv ( <a> , sep = ',' )	 <B> = pd . read_csv ( <a> , sep = ',' ) 
<A> の <b> 列と <c> と <d> 列について関係性を一度にプロットする	sns . pairplot ( <A> [ [ <b> , <c> , <d> ] ] )	 . pairplot ( <A> [ [ <b> , <c> , <d> ] ] ) 
データフレーム <C> の <b> をビン数を <A> 整数値としてビン分割する	pd . cut ( <C> [ <b> ] , <A> )	 <C> . pd ( [ <b> ] , <A> ) 
表 <B> の下 <a> 行	<B> . tail ( <a> )	 <B> . tail ( <a> ) 
ビンの名前をリスト <A> として、 <D> の <c> コラムを分割数を整数値 <B> として分割する	pd . cut ( <D> [ <c> ] , <B> , label = <A> )	 pd . cut ( <D> [ <c> ] , <B> , label = <A> ) 
表 <A> の先頭から <b> 行までを見る	<A> [ : <b> ]	 <A> [ <b> : ] 
表 <A> の列の名前	<A> . columns	 x <A> . columns 
<A> の <b> を並び替える	<A> . sort_values ( <b> )	 <A> . sort_values ( <b> ) 
表 <A> のカラム <b> を分割数を整数値 <C> としてビン分割する	pd . cut ( <A> [ <b> ] , <C> )	 pd . cut ( <A> [ <b> ] , <C> ) 
表データ <A> の列 <b> と <c> の相関	<A> [ [ <b> , <c> ] ] . corr ( )	 <D> [ [ <c> , <b> , <c> ] ] . corr ( ) 
表データ <A> の <b> を境界値を <C> としてビン分割する	pd . cut ( <A> [ <b> ] , <C> )	 pd . cut ( <A> [ <b> ] , <C> ) 
<A> の <b> と <c> と <d> について関係性を一気に描画する	sns . pairplot ( <A> [ [ <b> , <c> , <d> ] ] )	 <A> [ [ <b> , <c> , <d> ] ] . pairplot ( ) 
表データ <B> の <a> を NaN に置換し、 NaN がある行を落とす	<B> . replace ( <a> , np . nan ) . dropna ( )	 <E> . dropna ( <B> , np . nan ) . dropna ( ) 
<b> から <a> 区切りで表を読む	pd . read_csv ( <b> , sep = <a> )	 pd . read_csv ( <b> , sep = <a> ) 
表データ <A> の <b> と <c> ごとに <d> 列の値の合計値を計算する	<A> . groupby ( [ <b> , <c> ] ) [ <d> ] . sum ( )	 sns . groupby ( [ <A> [ <b> , <c> ] ) [ <d> ] . sum ( ) 
カラム <A> の平均値	<A> . mean ( )	 <A> . mean ( ) 
表データ <C> の <b> を境界値を <A> リストとして分割する	pd . cut ( <C> [ <b> ] , <A> )	 pd . cut ( <C> [ <b> ] , <A> ) 
<A> の <b> と <c> 列ごとに <d> の値の合計を計算する	<A> . groupby ( [ <b> , <c> ] ) [ <d> ] . sum ( )	 sns . groupby ( [ <A> [ <b> , <c> ] ) [ <d> ] . sum ( ) 
<C> の <b> をビン数を <A> としてビン分割する	pd . cut ( <C> [ <b> ] , <A> )	 <C> . pd ( [ <b> ] , <A> ) 
表データ <B> 中の <a> を NaN に置換し、 NaN がある行を消す	<B> . replace ( <a> , np . nan ) . dropna ( )	 <E> . dropna ( <B> , np . nan ) . dropna ( ) 
表データ <A> の <b> コラムと <c> ごとに <d> の値の合計値を算出する	<A> . groupby ( [ <b> , <c> ] ) [ <d> ] . sum ( )	 sns . groupby ( [ <A> [ <b> , <c> ] ) [ <d> ] . sum ( ) 
<A> の <b> をグループ化して、値ごとのデータの数	<A> . groupby ( <b> ) . size ( )	 . groupby ( <A> [ <b> ] ) . size ( ) 
データフレーム <A> の最初から <b> 行目まで	<A> [ : <b> ]	 <A> [ : <b> ] 
表データ <A> の <b> と <c> と <d> カラムについての箱ひげ図を描写する	plt . boxplot ( [ <A> [ <b> ] , <A> [ <c> ] , <A> [ <d> ] ] )	 sns . boxplot ( [ <A> [ <b> ] , <A> [ <c> ] , <A> [ <d> ] ] ) 
表 <A> の <b> を中央値でビン分割する	pd . qcut ( <A> [ <b> ] , 2 )	 . pd ( <A> [ <b> ] , 2 ) 
データフレーム <B> の <a> についての箱ひげ図を表示する	plt . boxplot ( <B> [ <a> ] )	 plt . boxplot ( <B> [ <a> ] ) 
データフレーム <D> の <c> カラムと <b> カラムと <a> について関係性を一気にプロットする	sns . pairplot ( <D> [ [ <c> , <b> , <a> ] ] )	 <D> [ [ <c> , <b> , <a> ] ] . pairplot ( ) 
データフレーム <C> の <b> をビン数を <A> としてビンに含まれる個数が等しくなるように分割する	pd . qcut ( <C> [ <b> ] , <A> )	 pd . qcut ( <C> [ <b> ] , <A> ) 
表データ <A> の <b> についての要約統計量	<A> [ <b> ] . describe ( )	 <A> [ <b> ] . describe ( ) 
表データ <A> の <b> についての最頻値を表示する	<A> [ <b> ] . mode ( )	 <A> [ <b> ] . mode ( ) 
ビンの名前を整数値として、 <C> の <b> をビン数を整数値 <A> として分割する	pd . cut ( <C> [ <b> ] , <A> , label = False )	 pd . cut ( <C> [ <b> ] , <A> , label = False ) 
表 <C> の <b> をビン数を <A> として分割する	pd . cut ( <C> [ <b> ] , <A> )	 <C> . pd ( [ <b> ] , <A> ) 
<B> の <a> を選択する	<B> [ <a> ]	 pd . set_option ( <B> [ <a> ] ) 
ビンの名前をリスト <A> として、 <D> の表属性 <c> をビン数を <B> 整数値として分割する	pd . cut ( <D> [ <c> ] , <B> , label = <A> )	 pd . cut ( <D> [ <c> ] , <B> , label = <A> ) 
<B> の先頭の <a> 行	<B> . head ( <a> )	 head . head ( <a> ) 
文字コードが shift_jis のファイル <a> を読み込む	pd . read_csv ( <a> , encoding = "shift_jis" )	 "shift_jis" pd . read_csv ( <a> , encoding = "shift_jis" ) 
表 <B> 内の <a> を NaN に置換し、 NaN がある行をドロップする	<B> . replace ( <a> , np . nan ) . dropna ( )	 np . dropna ( <B> , np . nan ) . dropna ( ) 
表 <E> のカラム <d> 、 <c> 、 <b> 、 <a> を表示する	<E> [ [ <d> , <c> , <b> , <a> ] ]	 sns . pairplot ( <D> [ [ <c> , <b> , <a> ] ] ) 
<B> の <a> を四分位数ごとで分割する	pd . qcut ( <B> [ <a> ] , 4 )	 pd . qcut ( <B> [ <a> ] , 4 ) 
表 <B> の表属性 <a> についての箱ひげ図を描写する	plt . boxplot ( <B> [ <a> ] )	 boxplot plt . boxplot ( <B> [ <a> ] ) 
表 <A> の <b> についてのヒストグラムを表示する	plt . hist ( <A> [ <b> ] )	 <A> [ <b> ] . hist ( ) 
<D> の <c> 列と <b> ごとに <a> の値の合計を計算する	<D> . groupby ( [ <c> , <b> ] ) [ <a> ] . sum ( )	 <D> . groupby ( [ <c> , <b> ] ) [ <a> ] . sum ( ) 
色を <C> として、 <A> と <B> の折れ線グラフをプロットする	plt . plot ( <A> , <B> , color = ( <C> ) )	 pd . merge ( <A> , <B> , color = ( <C> ) ) 
表データ <D> のカラム <c> と <b> ごとに <a> の値の合計を計算する	<D> . groupby ( [ <c> , <b> ] ) [ <a> ] . sum ( )	 <D> . groupby ( [ <c> , <b> ] ) [ <a> ] . sum ( ) 
データフレーム <B> の <a> を消し、 <C> とする	<C> = <B> . drop ( <a> , axis = 1 )	 <B> = <B> . drop ( <a> , axis = 1 ) 
表 <B> の表属性 <a> をインデックスに設定する	<B> . set_index ( <a> )	 <B> . set_index ( <a> ) 
表データ <A> の <b> 列の出現回数	<A> [ <b> ] . value_counts ( )	 軸 [ <b> ] . value_counts ( ) 
データフレーム <A> の <b> の前後の行の差分を計算	<A> [ <b> ] . diff ( periods = 1 )	 diff [ <b> ] . diff ( periods = 1 ) 
データフレーム <A> 内に存在する <b> を NaN に置換する	<A> . replace ( <b> , np . nan )	 <A> . replace ( <b> , np . nan ) 
データフレーム <A> の表属性 <b> と <c> ごとに <d> の値の合計を計算する	<A> . groupby ( [ <b> , <c> ] ) [ <d> ] . sum ( )	 sns . groupby ( [ <A> [ <b> , <c> ] ) [ <d> ] . sum ( ) 
全結合で <A> と <B> 表を一つにまとめる	pd . merge ( <A> , <B> , how = 'outer' )	 . pd ( <A> , <B> , how = 'outer' ) 
表 <A> の <b> カラムのユニークな要素数	<A> [ <b> ] . nunique ( )	 nunique [ <b> ] . nunique ( ) 
<A> の欠損を <B> に置き換える	<A> . fillna ( <B> )	 <A> . fillna ( <B> ) 
<C> の <b> とカラム <a> の相関	<C> [ [ <b> , <a> ] ] . corr ( )	 <E> [ [ <b> , <a> ] ] . corr ( ) 
<a> ファイルパスから表を <b> 区切りで読む	pd . read_csv ( <a> , sep = <b> )	 pd . read_csv ( <b> , sep = <a> ) 
<B> の表属性 <a> をグループ化して、値ごとのデータの数	<B> . groupby ( <a> ) . size ( )	 <C> . groupby ( <a> ) [ <b> ] . size ( ) 
表 <A> の <b> についての要約統計量を見る	<A> [ <b> ] . describe ( )	 <A> [ <b> ] . describe ( ) 
インデックスと <c> をキーとして表 <A> と <B> 表をマージする	pd . merge ( <A> , <B> , left_index = True , right_on = <c> )	 . pd ( <A> , <B> , left_index = True , right_on = <c> ) 
表データ <A> のカラム <b> を抽出する	<A> [ <b> ]	 plt . boxplot ( <A> [ <b> ] ) 
表データ <A> 内のそれぞれのカラムにある <b> の個数の合計値を確認する	<A> . isin ( [ <b> ] ) . sum ( )	 <A> . isin ( [ <b> ] ) . sum ( ) 
位置と <a> をキーとして <C> 表と <B> を結合する	pd . merge ( <C> , <B> , left_index = True , right_on = <a> )	 . pd ( <C> , <B> , left_index = True , right_on = <a> ) 
表データ <A> の相関	<A> . corr ( )	 <A> . corr ( ) 
<B> の <a> のバリュー	<B> [ <a> ] . values	 <B> [ <a> ] . values 
<A> 内のそれぞれのカラムにある <b> の個数の合計値を調べる	<A> . isin ( [ <b> ] ) . sum ( )	 <A> . isin ( [ <b> ] ) . sum ( ) 
表 <B> の <a> の要素	<B> [ <a> ] . values	 <B> [ <a> ] . values 
表データ <D> の <c> と <b> と <a> についての箱ひげ図を描写する	plt . boxplot ( [ <D> [ <c> ] , <D> [ <b> ] , <D> [ <a> ] ] )	 sns . boxplot ( [ <D> [ <c> ] , <D> [ <b> ] , <D> [ <a> ] ] ) 
表データ <B> の列 <c> を消し、 <A> にする	<A> = <B> . drop ( <c> , axis = 1 )	 <A> = <B> . drop ( <c> , axis = 1 ) 
データフレーム <A> の <b> 列を one - hot 表現に変換する	pd . get_dummies ( <A> [ <b> ] )	 pd . get_dummies ( <A> [ <b> ] ) 
ファイルパス <b> から表データをタブ区切りで読んで、 <A> にする	<A> = pd . read_csv ( <b> , sep = '\\\\t' )	 pd . read_csv ( <b> , sep = '\\\\t' ) 
<c> を項目名として、表 <A> と表 <B> をマージする	pd . merge ( <A> , <B> , on = <c> )	 pd . merge ( <A> , <B> , on = <c> ) 
表データ <A> の <b> についての中央値を調べる	<A> [ <b> ] . median ( )	 <A> [ <b> ] . median ( ) 
データフレーム <A> の <b> ごとに <c> の数をカウントする	<A> . groupby ( [ <b> ] ) [ <c> ] . count ( )	 <A> . groupby ( [ <b> ] ) [ <c> ] . count ( ) 
表 <D> の列 <c> と <b> と <a> について関係性を一度に描画する	sns . pairplot ( <D> [ [ <c> , <b> , <a> ] ] )	 <D> . sns ( [ [ <c> , <b> , <a> ] ] ) 
<A> にある <b> を欠損とする	<A> . replace ( <b> , np . nan )	 from matplotlib . replace ( <b> , np . nan ) 
表 <A> の <b> を四分位数ごとで分割する	pd . qcut ( <A> [ <b> ] , 4 )	 pd . qcut ( <A> [ <b> ] , 4 ) 
表 <A> の <b> カラムの名前を <c> に、 <d> カラムの名前を <e> に変更する	<A> . rename ( columns = { <b> : <c> , <d> : <e> } )	 <A> . rename ( columns = { <b> : <c> , <d> : <e> } ) 
表データ <A> の行の名前を <b> から <c> にリネームする	<A> . rename ( index = { <b> : <c> } )	 <D> . rename ( index = { <b> : <c> } ) 
表データ <A> の <b> と <c> とカラム <d> について関係性を一気に描く	sns . pairplot ( <A> [ [ <b> , <c> , <d> ] ] )	 . pairplot ( <A> [ [ <b> , <c> , <d> ] ] ) 
表を <a> から <b> 区切りで読む	pd . read_csv ( <a> , sep = <b> )	 pd . read_csv ( <b> , sep = <a> ) 
<A> の <b> コラムについての箱ひげ図をプロットする	plt . boxplot ( <A> [ <b> ] )	 boxplot plt . boxplot ( <A> [ <b> ] ) 
データフレーム <A> の <b> 行目から <c> 行目までを見る	<A> [ <b> : <c> ]	 <A> [ <b> : <c> ] 
<A> の <b> についての要約統計量	<A> [ <b> ] . describe ( )	 <A> [ <b> ] . describe ( ) 
表データ <A> の相関係数	<A> . corr ( )	 <A> . corr ( ) 
左外部結合で表 <A> と <B> を結合する	pd . merge ( <A> , <B> , how = 'left' )	 . pd ( <A> , <B> , how = 'left' ) 
<C> の <b> をビン数を <A> 整数値としてビン分割する	pd . cut ( <C> [ <b> ] , <A> )	 <C> . pd ( [ <b> ] , <A> ) 
データフレーム <A> の <b> をソートする	<A> . sort_values ( <b> )	 <A> . sort_values ( <b> ) 
タブ区切りで <a> を読み込む	pd . read_csv ( <a> , sep = '\\\\t' )	 '\\\\t' . read_csv ( <a> ) 
表データ <D> の <c> と <b> ごとに <a> 列の値の合計値を計算する	<D> . groupby ( [ <c> , <b> ] ) [ <a> ] . sum ( )	 <D> . groupby ( [ <c> , <b> ] ) [ <a> ] . sum ( ) 
ビンの名前を 0 始まりの連番として、表 <C> のコラム <b> を分割数を <A> としてビン分割する	pd . cut ( <C> [ <b> ] , <A> , label = False )	 pd . cut ( <C> [ <b> ] , <A> , label = False ) 
表 <A> の表属性 <b> をインデックスに設定する	<A> . set_index ( <b> )	 plt . set_index ( <A> [ <b> ] ) 
表データ <C> の位置 <b> の名前を <a> に変更する	<C> . rename ( index = { <b> : <a> } )	 <A> . rename ( index = { <b> : <a> } ) 
<A> の <b> と表属性 <c> を消す	<A> . drop ( [ <b> , <c> ] , axis = 1 )	 sns . pairplot ( <A> [ [ <b> , <c> ] ] ) 
<A> の <b> と <c> と <d> についての箱ひげ図を描画する	plt . boxplot ( [ <A> [ <b> ] , <A> [ <c> ] , <A> [ <d> ] ] )	 sns . boxplot ( [ <A> [ <b> ] , <A> [ <c> ] , <A> [ <d> ] ] ) 
ビンのラベルを <A> として、 <D> 表の <c> を分割数を <B> としてビン分割する	pd . cut ( <D> [ <c> ] , <B> , label = <A> )	 pd . cut ( <D> [ <c> ] , <B> , label = <A> ) 
<B> と <A> の散布図を表示する	plt . scatter ( <B> , <A> )	 <B> . set_index ( <A> ) 
全結合で <B> と表 <A> を結合する	pd . merge ( <B> , <A> , how = 'outer' )	 . pd ( <B> , <A> , how = 'outer' ) 
データフレーム <B> 内の <a> を欠損値に置換し、欠損値が存在する行を削除する	<B> . replace ( <a> , np . nan ) . dropna ( )	 <E> . dropna ( <B> , np . nan ) . dropna ( ) 
<a> 区切りでデータフレームを <b> から読んで、 <C> とする	<C> = pd . read_csv ( <b> , sep = <a> )	 <E> = pd . read_csv ( <a> , sep = <b> ) 
表 <B> のコラム <a> を削除し、インプレースする	<B> . drop ( <a> , axis = 1 , inplace = True )	 <E> . drop ( <B> , axis = 1 , inplace = True ) 
<A> の列の名前を <b> から <c> に、 <d> から <e> に変更する	<A> . rename ( columns = { <b> : <c> , <d> : <e> } )	 <A> . rename ( columns = { <b> : <c> , <d> : <e> } ) 
ビンのラベルを <A> リストとして、 <D> 表の <c> 列を分割数を <B> として分割する	pd . cut ( <D> [ <c> ] , <B> , label = <A> )	 pd . cut ( <D> [ <c> ] , <B> , label = <A> ) 
データフレーム <B> の列 <a> を中央値でビン分割する	pd . qcut ( <B> [ <a> ] , 2 )	 sns . pd ( <B> [ <a> ] , 2 ) 
<b> ファイルから表を <c> 区切りで読み込み、 <A> とする	<A> = pd . read_csv ( <b> , sep = <c> )	 pd . read_csv ( <b> , sep = <c> ) 
表データ <A> の統計情報	<A> . describe ( )	 <A> . describe ( ) 
表データ <A> の NaN を <A> の平均値で補う	<A> . fillna ( <A> . mean ( ) )	 <A> . fillna ( <A> . mean ( ) ) 
<A> の列 <b> を消して、インプレースする	<A> . drop ( <b> , axis = 1 , inplace = True )	 <A> . drop ( <b> , axis = 1 , inplace = True ) 
表データ <A> の <b> が <c> 以上のデータを抽出する	<A> [ <A> [ <b> ] >= <c> ]	 from <A> [ <A> [ <b> ] >= <c> ] 
<A> の表属性 <b> をグループ化して、値ごとのデータの数	<A> . groupby ( <b> ) . size ( )	 . groupby ( <A> [ <b> ] ) . size ( ) 
データフレーム <B> の <a> 列中の前後の行の差分を算出	<B> [ <a> ] . diff ( periods = 1 )	 <B> [ <a> ] . diff ( periods = 1 ) 
<A> の <b> 列を抽出する	<A> [ <b> ]	 軸 [ <b> ] 
<A> の <b> を四分位数ごとでビン分割する	pd . qcut ( <A> [ <b> ] , 4 )	 pd . qcut ( <A> [ <b> ] , 4 ) 
位置と <a> をキーとして <C> データフレームと <B> を結合する	pd . merge ( <C> , <B> , left_index = True , right_on = <a> )	 . pd ( <C> , <B> , left_index = True , right_on = <a> ) 
データフレーム <A> の表属性 <b> を昇順に並び替える	<A> . sort_values ( <b> )	 sort_values . sort_values ( <A> [ <b> ] ) 
<b> から <a> 区切りでデータフレームを読み込み、 <C> とする	<C> = pd . read_csv ( <b> , sep = <a> )	 pd . read_csv ( <b> , sep = <a> ) 
データフレーム <C> の <b> ごとに列 <a> の平均を計算する	<C> . groupby ( [ <b> ] ) [ <a> ] . mean ( )	 <A> . groupby ( [ <b> ] ) [ <a> ] . mean ( ) 
<B> の <a> を抽出する	<B> [ <a> ]	 plt . <B> ( <a> ) 
表 <A> の上 5 行を見る	<A> . head ( )	 head <A> . head ( ) 
<b> から表を <c> 区切りで読み込んで、 <A> とする	<A> = pd . read_csv ( <b> , sep = <c> )	 pd . read_csv ( <b> , sep = <c> ) 
表データ <B> のコラム <a> を昇順に並び替える	<B> . sort_values ( <a> )	 <B> . sort_values ( <a> ) 
ビンの数を <a> として、 <B> のヒストグラムを描画する	plt . hist ( <B> , bins = <a> )	 sns . hist ( <B> , bins = <a> ) 
<a> から表データをタブ区切りで読む	pd . read_csv ( <a> , sep = '\\\\t' )	 pd . read_csv ( <a> , sep = '\\\\t' ) 
表データ <A> の <b> と <c> 列をドロップする	<A> . drop ( [ <b> , <c> ] , axis = 1 )	 sns . pairplot ( <A> [ [ <b> , <c> ] ] ) 
表データ <B> の <a> 行から最後まで	<B> [ <a> : ]	 <B> [ <a> : ] 
表 <A> の <b> を分割数を <C> としてビン分割する	pd . cut ( <A> [ <b> ] , <C> )	 pd . cut ( <A> [ <b> ] , <C> ) 
グラフを表示する	plt . show ( )	 plt . show ( ) 
データフレーム <C> の <b> を分割数を <A> としてビン分割する	pd . cut ( <C> [ <b> ] , <A> )	 <C> . pd ( [ <b> ] , <A> ) 
<A> 中の <b> を欠損に置換し、欠損がある行を消す	<A> . replace ( <b> , np . nan ) . dropna ( )	 <A> . replace ( <b> , np . nan ) . dropna ( ) 
表 <A> を位置でソートする	<A> . sort_index ( )	 <A> . sort_index ( ) 
表 <B> のコラム <a> についての標準偏差	<B> [ <a> ] . std ( )	 <B> [ <a> ] . std ( ) 
<A> のコラム <b> をビン数を <C> としてビンに含まれる個数が等しくなるように分割する	pd . qcut ( <A> [ <b> ] , <C> )	 from pd . qcut ( <A> [ <b> ] , <C> ) 
データフレーム <A> の <b> についての箱ひげ図を表示する	plt . boxplot ( <A> [ <b> ] )	 pd . boxplot ( <A> [ <b> ] ) 
<B> のコラム <a> についての箱ひげ図をプロットする	plt . boxplot ( <B> [ <a> ] )	 pd . get_dummies ( <B> [ <a> ] ) 
表 <C> の列 <b> と <a> 列を降順にソートする	<C> . sort_values ( [ <b> , <a> ] , ascending = False )	 <E> . sort_values ( [ <b> , <a> ] , ascending = False ) 
全結合で表 <A> と <B> を結合する	pd . merge ( <A> , <B> , how = 'outer' )	 . pd ( <A> , <B> , how = 'outer' ) 
表 <A> の <b> についての平均値を調べる	<A> [ <b> ] . mean ( )	 <A> [ <b> ] . mean ( ) 
表データ <A> の <b> コラムと <c> コラムとコラム <d> についての箱ひげ図をプロットする	plt . boxplot ( [ <A> [ <b> ] , <A> [ <c> ] , <A> [ <d> ] ] )	 sns . boxplot ( [ <A> [ <b> ] , <A> [ <c> ] , <A> [ <d> ] ] ) 
全結合で <B> と表 <A> を一つにまとめる	pd . merge ( <B> , <A> , how = 'outer' )	 . pd ( <B> , <A> , how = 'outer' ) 
表 <B> 内に存在する <a> を NaN に置き換える	<B> . replace ( <a> , np . nan )	 pd . merge ( <B> , <A> , np . nan ) 
<A> の <b> を中央値で分割する	pd . qcut ( <A> [ <b> ] , 2 )	 <A> . pd ( [ <b> ] , 2 ) 
インデックスと <a> を項目名として <C> 表と <B> を結合する	pd . merge ( <C> , <B> , left_index = True , right_on = <a> )	 . pd ( <C> , <B> , left_index = True , right_on = <a> ) 
データフレームをファイルパス <a> からカンマ区切りで読み込む	pd . read_csv ( <a> , sep = ',' )	 pd . read_csv ( <a> , sep = ',' ) 
ファイル名 <a> からカンマ区切りでデータフレームを読み込む	pd . read_csv ( <a> , sep = ',' )	 pd . read_csv ( <a> , sep = ',' ) 
グラフの大きさを横 <b> 縦 <a> に指定する	plt . figure ( figsize = ( <b> , <a> ) )	 plt . figure ( figsize = ( <a> , <b> ) ) 
コラム <c> を項目名として、 <A> データフレームと <B> を一つにまとめる	pd . merge ( <A> , <B> , on = <c> )	 pd . merge ( <A> , <B> , on = <c> ) 
ビンの名前をリスト <A> として、 <D> の <c> を分割数を整数値 <B> としてビン分割する	pd . cut ( <D> [ <c> ] , <B> , label = <A> )	 pd . cut ( <D> [ <c> ] , <B> , label = <A> ) 
表データ <A> のカラム <b> を落とし、再代入する	<A> = <A> . drop ( <b> , axis = 1 )	 <A> = <A> . drop ( <b> , axis = 1 ) 
凡例を最適な位置に加える	plt . legend ( loc = 'best' )	 'best' plt . legend ( loc = 'best' ) 
データフレーム <A> をパス <b> に書き込む	<A> . to_csv ( <b> )	 <A> . to_csv ( <b> ) 
表データ <B> のカラム <a> 内の前後の行の差分を計算	<B> [ <a> ] . diff ( periods = 1 )	 <B> [ <a> ] . diff ( periods = 1 ) 
位置と <c> を項目名として表 <A> と表 <B> を一つにまとめる	pd . merge ( <A> , <B> , left_index = True , right_on = <c> )	 . pd ( <A> , <B> , left_index = True , right_on = <c> ) 
表データを <c> 区切りでファイル名 <b> から読み、 <A> とする	<A> = pd . read_csv ( <b> , sep = <c> )	 <A> = pd . read_csv ( <b> , sep = <c> ) 
表 <A> の <b> を削除して、置き換える	<A> = <A> . drop ( <b> , axis = 1 )	 <A> = <A> . drop ( <b> , axis = 1 ) 
カンマ区切りでデータフレームを <b> から読み込み、 <A> とする	<A> = pd . read_csv ( <b> , sep = ',' )	 <E> = pd . read_csv ( <b> , sep = ',' ) 
表データ <A> の <b> をビン数を整数値 <C> として要素数が等しくなるように分割する	pd . qcut ( <A> [ <b> ] , <C> )	 pd . qcut ( <A> [ <b> ] , <C> ) 
データフレーム <A> の <b> コラムが <c> のデータを抽出する	<A> [ <A> [ <b> ] == <c> ]	 from <A> [ <A> [ <b> ] == <c> ] 
表データ <E> の列名を <d> から <c> に、 <b> から <a> に変更する	<E> . rename ( columns = { <d> : <c> , <b> : <a> } )	 <C> . rename ( columns = { <b> : <c> , <d> : <a> } ) 
<b> からカンマ区切りで表を読んで、 <A> にする	<A> = pd . read_csv ( <b> , sep = ',' )	 <E> = pd . read_csv ( <b> , sep = ',' ) 
<B> の <a> を日付に変換する	pd . to_datetime ( <B> [ <a> ] , format = '%Y-%m-%d' )	 pd . to_datetime ( <B> [ <a> ] , format = '%Y-%m-%d' ) 
<A> の <b> についての中央値を見る	<A> [ <b> ] . median ( )	 <A> [ <b> ] . median ( ) 
ビンのラベルをリスト <A> として、 <D> データフレームのコラム <c> をビン数を <B> としてビン分割する	pd . cut ( <D> [ <c> ] , <B> , label = <A> )	 pd . cut ( <D> [ <c> ] , <B> , label = <A> ) 
<A> の <b> についての箱ひげ図を描画する	plt . boxplot ( <A> [ <b> ] )	 boxplot plt . boxplot ( <A> [ <b> ] ) 
データフレーム <A> の <b> 列と <c> と <d> について関係性を一気に描画する	sns . pairplot ( <A> [ [ <b> , <c> , <d> ] ] )	 . pairplot ( <A> [ [ <b> , <c> , <d> ] ] ) 
データフレーム <B> をファイルパス <a> に書き込む	<B> . to_csv ( <a> )	 <B> . to_csv ( <a> ) 
データフレーム <B> の <a> コラムについての箱ひげ図をプロットする	plt . boxplot ( <B> [ <a> ] )	 boxplot plt . boxplot ( <B> [ <a> ] ) 
表データ <A> の <b> のバリュー	<A> [ <b> ] . values	 <A> [ <b> ] . values 
ビンのラベルを <A> として、表 <D> の <c> を分割数を <B> 整数値として分割する	pd . cut ( <D> [ <c> ] , <B> , label = <A> )	 pd . cut ( <D> [ <c> ] , <B> , label = <A> ) 
<B> 中の <a> を NaN に置換し、 NaN がある行を消す	<B> . replace ( <a> , np . nan ) . dropna ( )	 <E> . dropna ( <B> , np . nan ) . dropna ( ) 
<E> の列 <d> の名前を <c> に、 <b> 列の名前を <a> にリネームする	<E> . rename ( columns = { <d> : <c> , <b> : <a> } )	 <A> . rename ( columns = { <b> : <c> , <d> : <a> } ) 
<B> を <a> に書き出す	<B> . to_csv ( <a> )	 <B> . to_csv ( <a> ) 
左外部結合で <B> と表データ <A> をマージする	pd . merge ( <B> , <A> , how = 'left' )	 <B> . pd ( <a> , how = 'left' ) 
データフレーム <A> 中の欠損を <A> 表の平均値で埋める	<A> . fillna ( <A> . mean ( ) )	 <A> . fillna ( <A> . mean ( ) ) 
<A> の表属性 <b> が <c> より小さいデータを抽出する	<A> [ <A> [ <b> ] <  <c> ]	 plt . boxplot ( <A> [ <b> ] , <A> [ <c> ] ) ] 
データフレーム <A> のコラム <b> ごとに <c> の平均値を計算する	<A> . groupby ( [ <b> ] ) [ <c> ] . mean ( )	 <A> . groupby ( [ <b> ] ) [ <c> ] . mean ( ) 
表データ <A> の <b> と <c> 表属性を降順にソートする	<A> . sort_values ( [ <b> , <c> ] , ascending = False )	 sns . sort_values ( [ <A> , <c> ] , ascending = False ) 
<A> の <b> 行から最後まで	<A> [ <b> : ]	 <A> [ <b> : ] 
グラフ幅を <a> として、 <C> 軸を <C> とした <B> の棒グラフを描画する	plt . bar ( <C> , <B> , width = <a> )	 pd . merge ( <C> , <B> , width = <a> ) 
ビンのラベルを <D> として、表 <A> の表属性 <b> をビン数を整数値 <C> として分割する	pd . cut ( <A> [ <b> ] , <C> , label = <D> )	 <A> . pd ( [ <b> ] , <C> , label = <D> ) 
データフレーム <A> の <b> を境界値を <C> としてビン分割する	pd . cut ( <A> [ <b> ] , <C> )	 pd . cut ( <A> [ <b> ] , <C> ) 
<A> 中の NaN の合計	<A> . isnull ( ) . sum ( )	 <A> . isnull ( ) . sum ( ) 
<A> のコラム <b> のバリュー	<A> [ <b> ] . values	 軸 [ <b> ] . values 
位置と <c> をキーとして <A> と <B> を一つにまとめる	pd . merge ( <A> , <B> , left_index = True , right_on = <c> )	 . pd ( <A> , <B> , left_index = True , right_on = <c> ) 
表属性 <A> の最頻値	<A> . mode ( )	 <A> . mode ( ) 
データフレーム <D> の <c> コラムと <b> とコラム <a> について関係性を一度に描く	sns . pairplot ( <D> [ [ <c> , <b> , <a> ] ] )	 <D> . sns ( [ [ <c> , <b> , <a> ] ] ) 
表データ <A> の <b> 表属性ごとに <c> 表属性の個数をカウントする	<A> . groupby ( [ <b> ] ) [ <c> ] . count ( )	 <A> . groupby ( [ <b> ] ) [ <c> ] . count ( ) 
表 <A> の <b> と <c> と <d> コラムについて関係性を一度に描く	sns . pairplot ( <A> [ [ <b> , <c> , <d> ] ] )	 . pairplot ( <A> [ [ <b> , <c> , <d> ] ] ) 
データフレーム <B> と <A> を縦方向で一つにまとめる	pd . concat ( [ <B> , <A> ] )	 concat . pd ( [ <B> , <A> ] ) 
カンマ区切りで表を <a> から読み込み、 <B> に代入する	<B> = pd . read_csv ( <a> , sep = ',' )	 <B> = pd . read_csv ( <a> , sep = ',' ) 
表 <A> の <b> 行を表示する	<A> . head ( <b> )	 <A> . head ( <b> ) 
表 <A> の <b> と <c> を落とす	<A> . drop ( [ <b> , <c> ] , axis = 1 )	 sns . pairplot ( <A> [ [ <b> , <c> ] ] ) 
<a> を x 軸につける	plt . xlabel ( <a> )	 plt . xlabel ( <a> ) 
ビンの名前を 0 始まりの連番として、 <A> の <b> を分割数を整数値 <C> として分割する	pd . cut ( <A> [ <b> ] , <C> , label = False )	 pd . cut ( <A> [ <b> ] , <C> , label = False ) 
表 <A> の <b> カラムを削除して、再代入する	<A> = <A> . drop ( <b> , axis = 1 )	 <A> = <A> . drop ( <b> , axis = 1 ) 
表データ <A> の <b> 表属性と表属性 <c> と <d> について関係性を一気にプロットする	sns . pairplot ( <A> [ [ <b> , <c> , <d> ] ] )	 pd . merge ( <A> [ <b> , <c> , <d> ] ] ) 
ヘッダーなしで <a> を読み込む	pd . read_csv ( <a> , header = None )	 pd . read_csv ( <a> , header = None ) 
区関の数を <b> として、 <A> のヒストグラムを描画する	plt . hist ( <A> , bins = <b> )	 sns . hist ( <A> , bins = <b> ) 
<a> 表属性を項目名として、表データ <C> と <B> 表データをマージする	pd . merge ( <C> , <B> , on = <a> )	 pd . merge ( <C> , <B> , on = <a> ) 
表データ <A> の列名を <b> から <c> に、 <d> から <e> に変更する	<A> . rename ( columns = { <b> : <c> , <d> : <e> } )	 sns . rename ( columns = { <b> : <c> , <d> : <e> } ) 
データフレーム <B> 中のそれぞれのカラムに存在する <a> の個数の合計値を見る	<B> . isin ( [ <a> ] ) . sum ( )	 plt . isin ( <B> [ <a> ] ) . sum ( ) 
データフレーム <C> の <b> とコラム <a> の相関係数	<C> [ [ <b> , <a> ] ] . corr ( )	 plt [ <C> , [ <b> , <a> ] ] . corr ( ) 
<A> の <b> を消す	<A> . drop ( [ <b> ] )	 <A> . drop ( <b> , axis = 1 ) 
<C> の <b> ごとに表属性 <a> の平均を算出する	<C> . groupby ( [ <b> ] ) [ <a> ] . mean ( )	 sns . groupby ( [ <b> ] ) [ <a> ] . mean ( ) 
<A> の表属性 <b> と <c> 表属性と <d> について関係性を一度にプロットする	sns . pairplot ( <A> [ [ <b> , <c> , <d> ] ] )	 . pairplot ( <A> [ [ <b> , <c> , <d> ] ] ) 
データフレーム <A> をファイル名 <b> に書き込む	<A> . to_csv ( <b> )	 <A> . to_csv ( <b> ) 
ビンのラベルを整数値として、表データ <C> のコラム <b> をビン数を <A> 整数値としてビン分割する	pd . cut ( <C> [ <b> ] , <A> , label = False )	 pd . cut ( <C> [ <b> ] , <A> , label = False ) 
データフレーム <A> 中の欠損値を <A> の平均値で補う	<A> . fillna ( <A> . mean ( ) )	 <A> . fillna ( <A> . mean ( ) ) 
表データ <B> の <a> 行から末尾まで	<B> [ <a> : ]	 <B> [ <a> : ] 
表データを <b> 区切りで <a> から読み込む	pd . read_csv ( <a> , sep = <b> )	 pd . read_csv ( <a> , sep = <b> ) 
ファイル <b> から <a> 区切りでデータフレームを読む	pd . read_csv ( <b> , sep = <a> )	 pd . read_csv ( <b> , sep = <a> ) 
<B> の <a> についてのヒストグラムをプロットする	plt . hist ( <B> [ <a> ] )	 <B> [ <a> ] . hist ( ) 
<B> の <a> を NaN に置換し、 NaN が存在する行を落とす	<B> . replace ( <a> , np . nan ) . dropna ( )	 <E> . dropna ( <B> , np . nan ) . dropna ( ) 
Matplotlib をインポートする	from matplotlib import pyplot as plt	 matplotlib import pyplot as sns 
表データ <D> の <c> と <b> と <a> カラムについての箱ひげ図を描写する	plt . boxplot ( [ <D> [ <c> ] , <D> [ <b> ] , <D> [ <a> ] ] )	 sns . boxplot ( [ <D> [ <c> ] , <D> [ <b> ] , <D> [ <a> ] ] ) 
<A> の <b> についての最頻値を表示する	<A> [ <b> ] . mode ( )	 <A> [ <b> ] . mode ( ) 
表 <A> の数値データ以外の要約統計量	<A> . describe ( include = "O" )	 plt . describe ( <A> . describe ( ) 
データフレーム <A> の <b> と <c> と <d> コラムについての箱ひげ図を表示する	plt . boxplot ( [ <A> [ <b> ] , <A> [ <c> ] , <A> [ <d> ] ] )	 plt . boxplot ( [ <A> [ <b> ] , <A> [ <c> ] , <A> [ <d> ] ] ) 
表データ <D> のカラム <c> とカラム <b> と <a> について関係性を一気にプロットする	sns . pairplot ( <D> [ [ <c> , <b> , <a> ] ] )	 <D> [ [ <c> , <b> , <a> ] ] . pairplot ( ) 
データフレーム <B> のカラム <a> 中の前後の行の差分を算出	<B> [ <a> ] . diff ( periods = 1 )	 <B> [ <a> ] . diff ( periods = 1 ) 
表データを <c> 区切りで <b> から読み、 <A> にする	<A> = pd . read_csv ( <b> , sep = <c> )	 pd . read_csv ( <b> , sep = <c> ) 
データフレーム <A> の <b> のユニークな要素の個数	<A> [ <b> ] . nunique ( )	 nunique <A> [ <b> ] . nunique ( ) 
ビンの名前を <A> リストとして、 <D> 表データの <c> をビン数を整数値 <B> としてビン分割する	pd . cut ( <D> [ <c> ] , <B> , label = <A> )	 pd . cut ( <D> [ <c> ] , <B> , label = <A> ) 
ビンのラベルをリスト <D> として、 <A> 表の <b> をビン数を <C> 整数値としてビン分割する	pd . cut ( <A> [ <b> ] , <C> , label = <D> )	 pd . cut ( <A> [ <b> ] , <C> , label = <D> ) 
表 <C> のカラム <b> が <a> より大きいデータを抽出する	<C> [ <C> [ <b> ] >  <a> ]	 sns <C> [ <C> [ <b> ] > <a> ] 
カラム <A> の標準偏差を表示する	<A> . std ( )	 <A> . std ( ) 
<A> の <b> を昇順に並び替える	<A> . sort_values ( <b> )	 <A> . sort_values ( <b> ) 
x 軸のラベルを <a> に変更する	plt . xlabel ( <a> )	 plt . xlabel ( <a> ) 
<C> 行 <B> 列の <a> つ目のグラフ指定	plt . subplot ( <C> , <B> , <a> )	 plt . plot ( <C> [ <b> ] , <a> ] ) 
表 <A> 中にある <b> を NaN に置き換える	<A> . replace ( <b> , np . nan )	 <A> . replace ( <b> , np . nan ) 
<B> の <a> を位置に設定する	<B> . set_index ( <a> )	 <E> . set_index ( <B> [ <a> ] ) 
データフレーム <A> のデータ型	<A> . dtypes	 from ) 
表データを <b> ファイルパスから <a> 区切りで読み込む	pd . read_csv ( <b> , sep = <a> )	 pd . read_csv ( <a> , sep = <b> ) 
<A> の NaN を <A> の平均値で補う	<A> . fillna ( <A> . mean ( ) )	 <A> . fillna ( <A> . mean ( ) ) 
カンマ区切りで <a> ファイル名から表を読み込んで、 <B> にする	<B> = pd . read_csv ( <a> , sep = ',' )	 <B> = pd . read_csv ( <a> , sep = ',' ) 
<D> のカラム <c> 、 <b> 、 <a> を表示する	<D> [ [ <c> , <b> , <a> ] ]	 sns . pairplot ( <D> [ [ <c> , <b> , <a> ] ] ) 
表 <B> の列 <a> を日付に変換する	pd . to_datetime ( <B> [ <a> ] , format = '%Y-%m-%d' )	 <B> pd . to_datetime ( <a> , format = '%Y-%m-%d' ) 
<A> のデータ型	<A> . dtypes	 from ) 
表データ <B> 内の NaN を <A> とする	<B> . fillna ( <A> )	 <A> . fillna ( <B> ) 
<B> の先頭から <a> 行目までを表示する	<B> [ : <a> ]	 : <B> [ <a> ] 
表 <B> の <a> を消し、置き換える	<B> . drop ( <a> , axis = 1 , inplace = True )	 <B> = <B> . drop ( <a> , axis = 1 ) 
表 <A> の <b> を datetime 型に変換する	pd . to_datetime ( <A> [ <b> ] , format = '%Y-%m-%d' )	 <A> . pd ( [ <b> ] , format = '%Y-%m-%d' ) 
データフレーム <A> の <b> と表属性 <c> と <d> について関係性を一気に描画する	sns . pairplot ( <A> [ [ <b> , <c> , <d> ] ] )	 sns . pairplot ( <A> [ [ <b> , <c> , <d> ] ] ) 
表 <D> の <c> 表属性と <b> ごとに <a> の値の合計値を算出する	<D> . groupby ( [ <c> , <b> ] ) [ <a> ] . sum ( )	 <D> . groupby ( [ <c> , <b> ] ) [ <a> ] . sum ( ) 
左外部結合で <B> と <A> 表データを一つにまとめる	pd . merge ( <B> , <A> , how = 'left' )	 <B> . pd ( <a> , how = 'left' ) 
表データ <A> の <b> 行から末尾までを表示する	<A> [ <b> : ]	 : <b> ) 
表データ <B> の <a> を昇順に並び替える	<B> . sort_values ( <a> )	 <B> . sort_values ( <a> ) 
データフレーム <A> の <b> 列についての標準偏差	<A> [ <b> ] . std ( )	 <A> [ <b> ] . std ( ) 
データフレーム <A> の上 <b> 行	<A> . head ( <b> )	 <A> . head ( <b> ) 
表データ <B> と表データ <A> を縦方向で一つにまとめる	pd . concat ( [ <B> , <A> ] )	 concat . pd ( [ <B> , <A> ] ) 
<A> の最初の 5 行を見る	<A> . head ( )	 <A> . head ( ) 
表データ <D> の表属性 <c> と <b> 表属性ごとに <a> 表属性の値の合計を求める	<D> . groupby ( [ <c> , <b> ] ) [ <a> ] . sum ( )	 <D> . groupby ( [ <c> , <b> ] ) [ <a> ] . sum ( ) 
表属性 <a> をキーとして、 <C> 表と <B> 表を結合する	pd . merge ( <C> , <B> , on = <a> )	 pd . merge ( <C> , <B> , on = <a> ) 
<a> をキーとして、 <C> と <B> 表をマージする	pd . merge ( <C> , <B> , on = <a> )	 pd . merge ( <C> , <B> , on = <a> ) 
データフレーム <D> の <c> と <b> と <a> についての箱ひげ図を描く	plt . boxplot ( [ <D> [ <c> ] , <D> [ <b> ] , <D> [ <a> ] ] )	 sns . boxplot ( [ <D> [ <c> ] , <D> [ <b> ] , <D> [ <a> ] ] ) 
表 <E> の <d> カラムの名前を <c> に、 <b> カラムの名前を <a> に変更する	<E> . rename ( columns = { <d> : <c> , <b> : <a> } )	 plt . rename ( columns = { <b> : <c> , <d> : <a> } ) 
表 <B> のコラム <a> を削除する	<B> . drop ( <a> , axis = 1 )	 pd . drop ( <B> [ <a> ] ) 
表 <B> 中の欠損を <A> に置き換える	<B> . fillna ( <A> )	 <A> . fillna ( <B> ) 
表 <C> の <b> を分割数を <A> として要素数が等しくなるようにビン分割する	pd . qcut ( <C> [ <b> ] , <A> )	 pd . qcut ( <C> [ <b> ] , <A> ) 
データフレーム <A> の <b> 表属性と <c> を降順に並び替える	<A> . sort_values ( [ <b> , <c> ] , ascending = False )	 . sort_values ( [ <A> , <b> ] , ascending = False ) 
表 <A> の <b> 列	<A> [ <b> ]	 values <A> [ <b> ] 
表データ <C> のカラム <b> と <a> の相関	<C> [ [ <b> , <a> ] ] . corr ( )	 <E> [ [ <b> , <a> ] ] . corr ( ) 
範囲を <b> から <a> として、 <C> のヒストグラムを描画する	plt . hist ( <C> , range = ( <b> , <a> ) )	 sns . hist ( <C> , range = ( <b> , <a> ) ) 
<A> の標準偏差	<A> . std ( )	 <A> . std ( ) 
<B> 中の NaN を <A> に置換する	<B> . fillna ( <A> )	 <A> . fillna ( <B> ) 
表 <B> のコラム <a> のバリュー	<B> [ <a> ] . values	 <B> [ <a> ] . values 
<B> 中の欠損を <A> とする	<B> . fillna ( <A> )	 <A> . fillna ( <B> ) 
<B> の <a> を中央値でビン分割する	pd . qcut ( <B> [ <a> ] , 2 )	 sns . pd ( <B> [ <a> ] , 2 ) 
<A> の <b> を分割数を <C> 整数値として要素数が等しくなるようにビン分割する	pd . qcut ( <A> [ <b> ] , <C> )	 pd . qcut ( <A> [ <b> ] , <C> ) 
<B> と <A> データフレームを縦結合する	pd . concat ( [ <B> , <A> ] )	 concat . pd ( [ <B> , <A> ] ) 
<D> の <c> が <b> または <a> のデータを抽出する	<D> [ <D> [ <c> ] . isin ( [ <b> , <a> ] ) ]	 isin [ <D> [ <c> ] . isin ( [ <b> , <a> ] ) ] 
ビンのラベルを <A> リストとして、 <D> の表属性 <c> をビン数を <B> として分割する	pd . cut ( <D> [ <c> ] , <B> , label = <A> )	 pd . cut ( <D> [ <c> ] , <B> , label = <A> ) 
<A> のオブジェクトデータの要約統計量	<A> . describe ( include = "O" )	 <A> . describe ( ) . describe ( ) 
表 <A> の <b> を落とす	<A> . drop ( <b> , axis = 1 )	 <A> . drop ( <b> , axis = 1 ) 
データフレーム <B> の <c> を消し、 <A> とする	<A> = <B> . drop ( <c> , axis = 1 )	 <B> = <B> . drop ( <c> , axis = 1 ) 
表データ <C> の <b> と <a> 列をドロップする	<C> . drop ( [ <b> , <a> ] , axis = 1 )	 <C> . drop ( [ <b> , <a> ] , axis = 1 ) 
表データ <D> のカラム <c> とカラム <b> と <a> について関係性を一気に描画する	sns . pairplot ( <D> [ [ <c> , <b> , <a> ] ] )	 <D> [ [ <c> , <b> , <a> ] ] . pairplot ( ) 
データフレーム <A> の <b> を四分位数ごとでビン分割する	pd . qcut ( <A> [ <b> ] , 4 )	 pd . qcut ( <A> [ <b> ] , 4 ) 
データフレーム <A> のカラム <b> を四分位数ごとで分割する	pd . qcut ( <A> [ <b> ] , 4 )	 . pd . qcut ( <A> [ <b> ] , 4 ) 
表データ <A> の <b> と <c> と <d> について関係性を一度にプロットする	sns . pairplot ( <A> [ [ <b> , <c> , <d> ] ] )	 . pairplot ( <A> [ [ <b> , <c> , <d> ] ] ) 
ビンの名前を整数値として、 <C> の <b> をビン数を <A> として分割する	pd . cut ( <C> [ <b> ] , <A> , label = False )	 pd . cut ( <C> [ <b> ] , <A> , label = False ) 
データフレーム <C> の列 <b> を境界値をリスト <A> としてビン分割する	pd . cut ( <C> [ <b> ] , <A> )	 pd . cut ( <C> [ <b> ] , <A> ) 
表データ <A> の先頭の 5 行を表示する	<A> . head ( )	 head <A> . head ( ) 
先頭の列をインデックスとして <a> を読む	pd . read_csv ( <a> , index_col = 0 )	 pd . read_csv ( <a> , index_col = 0 ) 
<D> の <c> とコラム <b> とコラム <a> について関係性を一気に描く	sns . pairplot ( <D> [ [ <c> , <b> , <a> ] ] )	 <D> . pairplot ( [ [ <c> , <b> , <a> ] ] ) 
表データ <D> の <c> と <b> ごとに <a> 表属性の値の合計を求める	<D> . groupby ( [ <c> , <b> ] ) [ <a> ] . sum ( )	 <D> . groupby ( [ <c> , <b> ] ) [ <a> ] . sum ( ) 
表 <C> の表属性 <b> が <a> のデータを抽出する	<C> [ <C> [ <b> ] == <a> ]	 <A> [ <C> [ <b> ] == <a> ] 
<A> の <b> を分割数を <C> として分割する	pd . cut ( <A> [ <b> ] , <C> )	 pd . cut ( <A> [ <b> ] , <C> ) 
表データ <D> の <c> 列と <b> ごとに <a> の値の合計を求める	<D> . groupby ( [ <c> , <b> ] ) [ <a> ] . sum ( )	 <D> . groupby ( [ <c> , <b> ] ) [ <a> ] . sum ( ) 
<a> をキーとして、 <C> 表データと表データ <B> を結合する	pd . merge ( <C> , <B> , on = <a> )	 pd . merge ( <C> , <B> , on = <a> ) 
表データ <B> の <a> を位置として設定する	<B> . set_index ( <a> )	 set_index <B> . set_index ( <a> ) 
データフレーム <A> のコラム <b> 中の前後の行の差分を算出	<A> [ <b> ] . diff ( periods = 1 )	 periods <A> [ <b> ] . diff ( periods = 1 ) 
データフレーム <A> の上 <b> 行を調べる	<A> . head ( <b> )	 <A> . head ( <b> ) 
インデックスと <c> をキーとして表データ <A> と <B> 表データを一つにまとめる	pd . merge ( <A> , <B> , left_index = True , right_on = <c> )	 . pd ( <A> , <B> , left_index = True , right_on = <c> ) 
<A> 内の null の合計	<A> . isnull ( ) . sum ( )	 <A> . isnull ( ) . sum ( ) 
ビンの名前を整数値として、 <A> データフレームの <b> を分割数を <C> として分割する	pd . cut ( <A> [ <b> ] , <C> , label = False )	 pd . cut ( <A> [ <b> ] , <C> , label = False ) 
<B> のそれぞれのカラムにある <a> の個数の合計値	<B> . isin ( [ <a> ] ) . sum ( )	 <B> . isin ( [ <a> ] ) . sum ( ) 
<A> 内に存在する <b> を NaN に置き換える	<A> . replace ( <b> , np . nan )	 <A> . replace ( <b> , np . nan ) 
区間を <b> として、 <A> のヒストグラムを描写する	plt . hist ( <A> , bins = <b> )	 pd . hist ( <A> , bins = <b> ) 
<A> の列の名前を <b> から <c> にリネームする	<A> . rename ( columns = { <b> : <c> } )	 <A> . rename ( columns = { <b> : <c> } ) 
表 <A> の <b> 列を表示する	<A> [ <b> ]	 軸 = <b> ) 
ビンのラベルをインデックスとして、表データ <C> の表属性 <b> を分割数を <A> として分割する	pd . cut ( <C> [ <b> ] , <A> , label = False )	 sns . cut ( <C> [ <b> ] , <A> , label = False ) 
ファイル名 <b> からデータフレームを <a> 区切りで読む	pd . read_csv ( <b> , sep = <a> )	 pd . read_csv ( <b> , sep = <a> ) 
表 <A> の <b> を四分位数ごとでビン分割する	pd . qcut ( <A> [ <b> ] , 4 )	 pd . qcut ( <A> [ <b> ] , 4 ) 
表データ <A> 中の <b> を欠損に置換し、欠損がある行を消す	<A> . replace ( <b> , np . nan ) . dropna ( )	 <A> . replace ( <b> , np . nan ) . dropna ( ) 
表データ <A> 中の欠損値をデータフレーム <A> の平均値で補う	<A> . fillna ( <A> . mean ( ) )	 <A> . fillna ( <A> . mean ( ) ) 
<b> 区切りで <a> を読み込む	pd . read_csv ( <a> , sep = <b> )	 import <b> pd . read_csv ( <a> ) 
表 <A> の <b> 表属性を昇順にソートする	<A> . sort_values ( <b> )	 pd . to_datetime ( <A> [ <b> ] , ascending = False ) 
インデックスと <a> を項目名として <C> と表 <B> を一つにまとめる	pd . merge ( <C> , <B> , left_index = True , right_on = <a> )	 pd . merge ( <C> , <B> , left_index = True , right_on = <a> ) 
インデックスと <a> をキーとして <C> と <B> を結合する	pd . merge ( <C> , <B> , left_index = True , right_on = <a> )	 . pd ( <C> , <B> , left_index = True , right_on = <a> ) 
表データ <A> の <b> カラムが <c> より大きいデータを抽出する	<A> [ <A> [ <b> ] >  <c> ]	 plt . boxplot ( <A> [ <b> ] , <A> [ <c> ] ) ] 
<A> の <b> コラムの要素	<A> [ <b> ] . values	 軸 [ <b> ] . values 
表 <A> の <b> を削除する	<A> . drop ( <b> , axis = 1 )	 pd . drop ( <A> [ <b> ] ) 
表 <D> のカラム <c> 、 <b> 、 <a> を見る	<D> [ [ <c> , <b> , <a> ] ]	 sns . pairplot ( <D> [ [ <c> , <b> , <a> ] ] ) 
データフレーム <D> の <c> と <b> コラムと <a> について関係性を一気に描画する	sns . pairplot ( <D> [ [ <c> , <b> , <a> ] ] )	 <D> . sns ( [ [ <c> , <b> , <a> ] ] ) 
データフレーム <A> の末尾 <b> 行	<A> . tail ( <b> )	 <A> . tail ( <b> ) 
表 <D> の <c> と <b> ごとに <a> の値の合計値を算出する	<D> . groupby ( [ <c> , <b> ] ) [ <a> ] . sum ( )	 <D> . groupby ( [ <c> , <b> ] ) [ <a> ] . sum ( ) 
<A> のカラム <b> 、 <c> 、 <d> 、 <e> を調べる	<A> [ [ <b> , <c> , <d> , <e> ] ]	 <E> [ [ <d> , <c> , <b> , <c> , <e> ] ] ) 
データフレーム <A> の <b> についての最頻値	<A> [ <b> ] . mode ( )	 from mode [ <b> ] . mode ( ) 
データフレーム <A> の <b> と <c> ごとに <d> 表属性の値の合計を算出する	<A> . groupby ( [ <b> , <c> ] ) [ <d> ] . sum ( )	 sns . groupby ( [ <A> [ <b> , <c> ] ) [ <d> ] . sum ( ) 
データフレーム <B> の <a> についての平均値を確認する	<B> [ <a> ] . mean ( )	 <B> [ <a> ] . mean ( ) 
表データ <A> の <b> 列を分割数を <C> としてビン分割する	pd . cut ( <A> [ <b> ] , <C> )	 pd . cut ( <A> [ <b> ] , <C> ) 
表データ <B> 内の欠損値を <A> に置換する	<B> . fillna ( <A> )	 <A> . fillna ( <B> ) 
<a> を項目名として、 <C> と <B> を一つにまとめる	pd . merge ( <C> , <B> , on = <a> )	 pd . merge ( <C> , <B> , on = <a> ) 
表データ <B> の <a> を欠損に置換し、欠損がある行を削除する	<B> . replace ( <a> , np . nan ) . dropna ( )	 <E> . dropna ( <B> , np . nan ) . dropna ( ) 
位置と <c> を項目名として <A> と <B> 表データを結合する	pd . merge ( <A> , <B> , left_index = True , right_on = <c> )	 . pd ( <A> , <B> , left_index = True , right_on = <c> ) 
表データ <A> のコラム <b> を年月日の形式に変換する	pd . to_datetime ( <A> [ <b> ] , format = '%Y-%m-%d' )	 <A> . pd ( [ <b> ] , format = '%Y-%m-%d' ) 
表 <A> の <b> の出現回数	<A> [ <b> ] . value_counts ( )	 軸 [ <b> ] . value_counts ( ) 
列 <A> の要約統計量	<A> . describe ( )	 <A> . describe ( ) 
表データ <B> の <a> の各要素の出現回数	<B> [ <a> ] . value_counts ( )	 <E> [ <B> [ <a> ] . value_counts ( ) 
<c> を項目名として、 <A> と <B> 表を結合する	pd . merge ( <A> , <B> , on = <c> )	 pd . merge ( <A> , <B> , on = <c> ) 
<D> の <c> と <b> 列ごとに <a> の値の合計を計算する	<D> . groupby ( [ <c> , <b> ] ) [ <a> ] . sum ( )	 <D> . groupby ( [ <c> , <b> ] ) [ <a> ] . sum ( ) 
ビンの名前を整数値として、データフレーム <C> の <b> をビン数を <A> としてビン分割する	pd . cut ( <C> [ <b> ] , <A> , label = False )	 pd . cut ( <C> [ <b> ] , <A> , label = False ) 
全結合で <A> と表 <B> をマージする	pd . merge ( <A> , <B> , how = 'outer' )	 . pd ( <A> , <B> , how = 'outer' ) 
表 <B> の <a> のユニークな要素の個数	<B> [ <a> ] . nunique ( )	 <B> [ <a> ] . nunique ( ) 
<b> をカンマ区切りで読み、 <A> にする	<A> = pd . read_csv ( <b> , sep = ',' )	 pd . read_csv ( <b> , sep = ',' ) 
表データ <A> の欠損を <B> に置換する	<A> . fillna ( <B> )	 <A> . fillna ( <B> ) 
<D> の <c> 表属性と <b> 表属性と <a> について関係性を一度に描画する	sns . pairplot ( <D> [ [ <c> , <b> , <a> ] ] )	 <D> . sns ( [ [ <c> , <b> , <a> ] ] ) 
<B> 内の <a> を NaN に置換し、 NaN が存在する行を削除する	<B> . replace ( <a> , np . nan ) . dropna ( )	 <E> . dropna ( <B> , np . nan ) . dropna ( ) 
タブ区切りで <a> を読む	pd . read_csv ( <a> , sep = '\\\\t' )	 '\\\\t' . pd ( <a> ) 
<A> の円グラフをプロットする	plt . pie ( <A> )	 <A> . plt ( ) 
表 <A> の <b> カラムについての箱ひげ図を描写する	plt . boxplot ( <A> [ <b> ] )	 boxplot plt . boxplot ( <A> [ <b> ] ) 
表 <B> の <c> を消し、 <A> にする	<A> = <B> . drop ( <c> , axis = 1 )	 <A> = <B> . drop ( <c> , axis = 1 ) 
表データを <b> ファイルパスから <c> 区切りで読み込み、 <A> とする	<A> = pd . read_csv ( <b> , sep = <c> )	 <A> = pd . read_csv ( <b> , sep = <c> ) 
